URL	Name	Music Attr	Value
Floating_Point	Floating Point	dbo:artist	dbr:John_McLaughlin_(musician)
Led_Zeppelin_II	Led Zeppelin II	dbo:artist	dbr:Led_Zeppelin
OK_Computer	OK Computer	dbo:artist	dbr:Radiohead
Kid_A	Kid A	dbo:artist	dbr:Radiohead
Brian_Wilson_Presents_Smile	Brian Wilson Presents Smile	dbo:artist	dbr:Brian_Wilson
What%27s_Going_On_(Marvin_Gaye_album)	What's Going On (Marvin Gaye album)	dbo:artist	dbr:Marvin_Gaye
The_Sun_Don%27t_Lie	The Sun Don't Lie	dbo:artist	dbr:Marcus_Miller
Marcus_Miller_(album)	Marcus Miller (album)	dbo:artist	dbr:Marcus_Miller
Suddenly_(Marcus_Miller_album)	Suddenly (Marcus Miller album)	dbo:artist	dbr:Marcus_Miller
Kind_of_Blue	Kind of Blue	dbo:artist	dbr:Miles_Davis
Congregation_(album)	Congregation (album)	dbo:artist	dbr:The_Afghan_Whigs
At_Fillmore_East	At Fillmore East	dbo:artist	dbr:The_Allman_Brothers_Band
Paul%27s_Boutique	Paul's Boutique	dbo:artist	dbr:Beastie_Boys
No_More_Mr._Nice_Guy_(Gang_Starr_album)	No More Mr. Nice Guy (Gang Starr album)	dbo:artist	dbr:Gang_Starr
Fear_of_a_Black_Planet	Fear of a Black Planet	dbo:artist	dbr:Public_Enemy_(band)
Hypocrisy_Is_the_Greatest_Luxury	Hypocrisy Is the Greatest Luxury	dbo:artist	dbr:The_Disposable_Heroes_of_Hiphoprisy
Bitches_Brew	Bitches Brew	dbo:artist	dbr:Miles_Davis
Schizophrenia_(Wayne_Shorter_album)	Schizophrenia (Wayne Shorter album)	dbo:artist	dbr:Wayne_Shorter
The_Soft_Parade	The Soft Parade	dbo:artist	dbr:The_Doors
Head_Hunters	Head Hunters	dbo:artist	dbr:Herbie_Hancock
Somethin%27_Else_(Cannonball_Adderley_album)	Somethin' Else (Cannonball Adderley album)	dbo:artist	dbr:Cannonball_Adderley
Post_(Bj%C3%B6rk_album)	Post (Björk album)	dbo:artist	dbr:Björk
Spirit_of_Eden	Spirit of Eden	dbo:artist	dbr:Talk_Talk
Miles_Ahead	Miles Ahead	dbo:artist	dbr:Miles_Davis
After_the_Gold_Rush	After the Gold Rush	dbo:artist	dbr:Neil_Young
Trout_Mask_Replica	Trout Mask Replica	dbo:artist	dbr:Captain_Beefheart
Cure_for_Pain	Cure for Pain	dbo:artist	dbr:Morphine_(band)
Frances_the_Mute	Frances the Mute	dbo:artist	dbr:The_Mars_Volta
Incunabula_(album)	Incunabula (album)	dbo:artist	dbr:Autechre
Portrait_in_Jazz	Portrait in Jazz	dbo:artist	dbr:Bill_Evans
Explorations_(Bill_Evans_album)	Explorations (Bill Evans album)	dbo:artist	dbr:Bill_Evans
Giant_Steps	Giant Steps	dbo:artist	dbr:John_Coltrane
New_Jazz_Conceptions	New Jazz Conceptions	dbo:artist	dbr:Bill_Evans
Maiden_Voyage_(Herbie_Hancock_album)	Maiden Voyage (Herbie Hancock album)	dbo:artist	dbr:Herbie_Hancock
Embryonic	Embryonic	dbo:artist	dbr:The_Flaming_Lips
Sunday_at_the_Village_Vanguard	Sunday at the Village Vanguard	dbo:artist	dbr:Bill_Evans
A_Love_Supreme	A Love Supreme	dbo:artist	dbr:John_Coltrane
Birth_of_the_Cool	Birth of the Cool	dbo:artist	dbr:Miles_Davis
Ill_Communication	Ill Communication	dbo:artist	dbr:Beastie_Boys
Stand!	Stand!	dbo:artist	dbr:Sly_and_the_Family_Stone
Dose_(album)	Dose (album)	dbo:artist	dbr:Gov't_Mule
Shakti_(album)	Shakti (album)	dbo:artist	dbr:Shakti_(band)
Jaco_Pastorius_(album)	Jaco Pastorius (album)	dbo:artist	dbr:Jaco_Pastorius
Now_He_Sings,_Now_He_Sobs	Now He Sings, Now He Sobs	dbo:artist	dbr:Chick_Corea
Birds_of_Fire	Birds of Fire	dbo:artist	dbr:Mahavishnu_Orchestra
The_Inner_Mounting_Flame	The Inner Mounting Flame	dbo:artist	dbr:Mahavishnu_Orchestra
Blue_Train_(album)	Blue Train (album)	dbo:artist	dbr:John_Coltrane
Brown_Sugar_(D%27Angelo_album)	Brown Sugar (D'Angelo album)	dbo:artist	dbr:D'Angelo
Sketches_of_Spain	Sketches of Spain	dbo:artist	dbr:Miles_Davis
Svengali_(album)	Svengali (album)	dbo:artist	dbr:Gil_Evans
%27Round_About_Midnight	'Round About Midnight	dbo:artist	dbr:Miles_Davis
Dis_Is_da_Drum	Dis Is da Drum	dbo:artist	dbr:Herbie_Hancock
Filles_de_Kilimanjaro	Filles de Kilimanjaro	dbo:artist	dbr:Miles_Davis
Giant_Steps_(composition)	Giant Steps (composition)	dbo:artist	dbr:John_Coltrane
Fresh_(Sly_and_the_Family_Stone_album)	Fresh (Sly and the Family Stone album)	dbo:artist	dbr:Sly_and_the_Family_Stone
Relaxin%27_with_the_Miles_Davis_Quintet	Relaxin' with the Miles Davis Quintet	dbo:artist	dbr:Miles_Davis
Steamin%27_with_the_Miles_Davis_Quintet	Steamin' with the Miles Davis Quintet	dbo:artist	dbr:Miles_Davis
Workin%27_with_the_Miles_Davis_Quintet	Workin' with the Miles Davis Quintet	dbo:artist	dbr:Miles_Davis
Cookin%27_with_the_Miles_Davis_Quintet	Cookin' with the Miles Davis Quintet	dbo:artist	dbr:Miles_Davis
Milestones_(Miles_Davis_album)	Milestones (Miles Davis album)	dbo:artist	dbr:Miles_Davis
Someday_My_Prince_Will_Come_(Miles_Davis_album)	Someday My Prince Will Come (Miles Davis album)	dbo:artist	dbr:Miles_Davis
Seven_Steps_to_Heaven	Seven Steps to Heaven	dbo:artist	dbr:Miles_Davis
E.S.P._(Miles_Davis_album)	E.S.P. (Miles Davis album)	dbo:artist	dbr:Miles_Davis
Miles_Smiles	Miles Smiles	dbo:artist	dbr:Miles_Davis
Sorcerer_(Miles_Davis_album)	Sorcerer (Miles Davis album)	dbo:artist	dbr:Miles_Davis
Nefertiti_(Miles_Davis_album)	Nefertiti (Miles Davis album)	dbo:artist	dbr:Miles_Davis
Miles_in_the_Sky	Miles in the Sky	dbo:artist	dbr:Miles_Davis
The_Complete_Live_at_the_Plugged_Nickel_1965	The Complete Live at the Plugged Nickel 1965	dbo:artist	dbr:Miles_Davis
In_a_Silent_Way	In a Silent Way	dbo:artist	dbr:Miles_Davis
Jack_Johnson_(album)	Jack Johnson (album)	dbo:artist	dbr:Miles_Davis
On_the_Corner	On the Corner	dbo:artist	dbr:Miles_Davis
Get_Up_with_It	Get Up with It	dbo:artist	dbr:Miles_Davis
Big_Fun_(Miles_Davis_album)	Big Fun (Miles Davis album)	dbo:artist	dbr:Miles_Davis
Band_of_Gypsys	Band of Gypsys	dbo:artist	dbr:Jimi_Hendrix
My_Favorite_Things_(album)	My Favorite Things (album)	dbo:artist	dbr:John_Coltrane
Secrets_(Herbie_Hancock_album)	Secrets (Herbie Hancock album)	dbo:artist	dbr:Herbie_Hancock
In_the_Wee_Small_Hours	In the Wee Small Hours	dbo:artist	dbr:Frank_Sinatra
Miles_Davis_discography	Miles Davis discography	dbo:artist	dbr:Miles_Davis
Third_(Soft_Machine_album)	Third (Soft Machine album)	dbo:artist	dbr:Soft_Machine
Tutu_(album)	Tutu (album)	dbo:artist	dbr:Miles_Davis
Impressions_(John_Coltrane_album)	Impressions (John Coltrane album)	dbo:artist	dbr:John_Coltrane
2001_(Dr._Dre_album)	2001 (Dr. Dre album)	dbo:artist	dbr:Dr._Dre
Live_at_Sin-%C3%A9_(Legacy_Edition)	Live at Sin-é (Legacy Edition)	dbo:artist	dbr:Jeff_Buckley
Monk%27s_Music	Monk's Music	dbo:artist	dbr:Thelonious_Monk
Porgy_and_Bess_(Miles_Davis_album)	Porgy and Bess (Miles Davis album)	dbo:artist	dbr:Miles_Davis
M%C2%B2_(album)	M² (album)	dbo:artist	dbr:Marcus_Miller
The_Reality_of_My_Surroundings	The Reality of My Surroundings	dbo:artist	dbr:Fishbone
Fahrenheit_(Toto_album)	Fahrenheit (Toto album)	dbo:artist	dbr:Toto_(band)
The_Man_with_the_Horn	The Man with the Horn	dbo:artist	dbr:Miles_Davis
Art_Blakey_discography	Art Blakey discography	dbo:artist	dbr:Art_Blakey
Musikk_Fra_Hybridene	Musikk Fra Hybridene	dbo:artist	dbr:Farmers_Market_(band)
Transition_(John_Coltrane_album)	Transition (John Coltrane album)	dbo:artist	dbr:John_Coltrane
The_Allman_Brothers_Band_(album)	The Allman Brothers Band (album)	dbo:artist	dbr:The_Allman_Brothers_Band
Late_Night_Tales:_The_Flaming_Lips	Late Night Tales: The Flaming Lips	dbo:artist	dbr:The_Flaming_Lips
Future_2_Future	Future 2 Future	dbo:artist	dbr:Herbie_Hancock
Tago_Mago	Tago Mago	dbo:artist	dbr:Can_(band)
The_Blues_and_the_Abstract_Truth	The Blues and the Abstract Truth	dbo:artist	dbr:Oliver_Nelson
Speak_No_Evil	Speak No Evil	dbo:artist	dbr:Wayne_Shorter
JuJu_(album)	JuJu (album)	dbo:artist	dbr:Wayne_Shorter
Blue_Haze	Blue Haze	dbo:artist	dbr:Miles_Davis
Silver_Rain	Silver Rain	dbo:artist	dbr:Marcus_Miller
Live-Evil_(Miles_Davis_album)	Live-Evil (Miles Davis album)	dbo:artist	dbr:Miles_Davis
The_Complete_Bitches_Brew_Sessions	The Complete Bitches Brew Sessions	dbo:artist	dbr:Miles_Davis
The_Coming	The Coming	dbo:artist	dbr:Busta_Rhymes
Hymn_of_the_Seventh_Galaxy	Hymn of the Seventh Galaxy	dbo:artist	dbr:Return_to_Forever
No_Mystery	No Mystery	dbo:artist	dbr:Return_to_Forever
Truth_Crushed_to_Earth_Shall_Rise_Again	Truth Crushed to Earth Shall Rise Again	dbo:artist	dbr:House_of_Pain
Crescent_(John_Coltrane_album)	Crescent (John Coltrane album)	dbo:artist	dbr:John_Coltrane
Ol%C3%A9_Coltrane	Olé Coltrane	dbo:artist	dbr:John_Coltrane
Coltrane_Plays_the_Blues	Coltrane Plays the Blues	dbo:artist	dbr:John_Coltrane
Where_Have_I_Known_You_Before	Where Have I Known You Before	dbo:artist	dbr:Return_to_Forever
Romantic_Warrior	Romantic Warrior	dbo:artist	dbr:Return_to_Forever
Light_as_a_Feather	Light as a Feather	dbo:artist	dbr:Return_to_Forever
The_Infamous	The Infamous	dbo:artist	dbr:Mobb_Deep
Live_at_the_House_of_Tribes	Live at the House of Tribes	dbo:artist	dbr:Wynton_Marsalis
Van_Gogh_by_Numbers	Van Gogh by Numbers	dbo:artist	dbr:Christos_Rafalides
Van_Gogh_by_Numbers	Van Gogh by Numbers	dbo:artist	dbr:Joe_Locke
Santana_(1971_album)	Santana (1971 album)	dbo:artist	dbr:Santana_(band)
Conversations_with_Myself	Conversations with Myself	dbo:artist	dbr:Bill_Evans
That%27s_What_I_Say:_John_Scofield_Plays_the_Music_of_Ray_Charles	That's What I Say: John Scofield Plays the Music of Ray Charles	dbo:artist	dbr:John_Scofield
Stellar_Regions	Stellar Regions	dbo:artist	dbr:John_Coltrane
Here_to_Save_You_All	Here to Save You All	dbo:artist	dbr:Chino_XL
My_Way_(Frank_Sinatra_album)	My Way (Frank Sinatra album)	dbo:artist	dbr:Frank_Sinatra
Interstellar_Space	Interstellar Space	dbo:artist	dbr:John_Coltrane
Wrath_of_the_Math	Wrath of the Math	dbo:artist	dbr:Jeru_the_Damaja
The_Tony_Bennett/Bill_Evans_Album	The Tony Bennett/Bill Evans Album	dbo:artist	dbr:Tony_Bennett
The_Tony_Bennett/Bill_Evans_Album	The Tony Bennett/Bill Evans Album	dbo:artist	dbr:Bill_Evans
Thelonious_Monk_with_John_Coltrane	Thelonious Monk with John Coltrane	dbo:artist	dbr:Thelonious_Monk
Undercurrent_(Bill_Evans_and_Jim_Hall_album)	Undercurrent (Bill Evans and Jim Hall album)	dbo:artist	dbr:Jim_Hall_(musician)
Undercurrent_(Bill_Evans_and_Jim_Hall_album)	Undercurrent (Bill Evans and Jim Hall album)	dbo:artist	dbr:Bill_Evans
Miles_Davis_Volume_2	Miles Davis Volume 2	dbo:artist	dbr:Miles_Davis
Waltz_for_Debby_(1962_album)	Waltz for Debby (1962 album)	dbo:artist	dbr:Bill_Evans
Yerself_Is_Steam	Yerself Is Steam	dbo:artist	dbr:Mercury_Rev
Miles_Davis_Volume_1	Miles Davis Volume 1	dbo:artist	dbr:Miles_Davis
Sun_Ship	Sun Ship	dbo:artist	dbr:John_Coltrane
Welcome_(Santana_album)	Welcome (Santana album)	dbo:artist	dbr:Santana_(band)
Tourist_(St_Germain_album)	Tourist (St Germain album)	dbo:artist	dbr:St_Germain_(musician)
Apocalypse_(Mahavishnu_Orchestra_album)	Apocalypse (Mahavishnu Orchestra album)	dbo:artist	dbr:Mahavishnu_Orchestra
%27Round_Midnight_(song)	'Round Midnight (song)	dbo:artist	dbr:Thelonious_Monk
Miles:_The_New_Miles_Davis_Quintet	Miles: The New Miles Davis Quintet	dbo:artist	dbr:Miles_Davis
Walkin%27	Walkin'	dbo:artist	dbr:Miles_Davis
Miles_Davis_and_the_Modern_Jazz_Giants	Miles Davis and the Modern Jazz Giants	dbo:artist	dbr:Miles_Davis
Bags%27_Groove	Bags' Groove	dbo:artist	dbr:Miles_Davis
Live_at_the_Village_Vanguard_Again!	Live at the Village Vanguard Again!	dbo:artist	dbr:John_Coltrane
Quintet/Sextet	Quintet/Sextet	dbo:artist	dbr:Milt_Jackson
Quintet/Sextet	Quintet/Sextet	dbo:artist	dbr:Miles_Davis
A_Night_at_the_Village_Vanguard	A Night at the Village Vanguard	dbo:artist	dbr:Sonny_Rollins
You%27re_Under_Arrest_(Miles_Davis_album)	You're Under Arrest (Miles Davis album)	dbo:artist	dbr:Miles_Davis
Star_People	Star People	dbo:artist	dbr:Miles_Davis
Aura_(Miles_Davis_album)	Aura (Miles Davis album)	dbo:artist	dbr:Miles_Davis
Amandla_(album)	Amandla (album)	dbo:artist	dbr:Miles_Davis
Decoy_(album)	Decoy (album)	dbo:artist	dbr:Miles_Davis
Dingo_(soundtrack)	Dingo (soundtrack)	dbo:artist	dbr:Miles_Davis
Dingo_(soundtrack)	Dingo (soundtrack)	dbo:artist	dbr:Michel_Legrand
Doo-Bop	Doo-Bop	dbo:artist	dbr:Miles_Davis
Sweet_Rain	Sweet Rain	dbo:artist	dbr:Stan_Getz
Raoul_and_the_Kings_of_Spain	Raoul and the Kings of Spain	dbo:artist	dbr:Tears_for_Fears
Back_on_the_Block	Back on the Block	dbo:artist	dbr:Quincy_Jones
Milestones_(instrumental_composition)	Milestones (instrumental composition)	dbo:artist	dbr:Miles_Davis
The_Complete_Village_Vanguard_Recordings,_1961	The Complete Village Vanguard Recordings, 1961	dbo:artist	dbr:Bill_Evans
Album_(Public_Image_Ltd_album)	Album (Public Image Ltd album)	dbo:artist	dbr:Public_Image_Ltd
Money_Jungle	Money Jungle	dbo:artist	dbr:Duke_Ellington
Money_Jungle	Money Jungle	dbo:artist	dbr:Max_Roach
The_Great_Jazz_Piano_of_Phineas_Newborn_Jr.	The Great Jazz Piano of Phineas Newborn Jr.	dbo:artist	dbr:Phineas_Newborn,_Jr.
A_Night_in_Tunisia	A Night in Tunisia	dbo:artist	dbr:Dizzy_Gillespie
Escalator_over_the_Hill	Escalator over the Hill	dbo:artist	dbr:Carla_Bley
Escalator_over_the_Hill	Escalator over the Hill	dbo:artist	dbr:Paul_Haines_(poet)
Milagro_(Santana_album)	Milagro (Santana album)	dbo:artist	dbr:Santana_(band)
Love_Devotion_Surrender	Love Devotion Surrender	dbo:artist	dbr:Carlos_Santana
The_Dangermen_Sessions_Vol._1	The Dangermen Sessions Vol. 1	dbo:artist	dbr:Madness_(band)
Jazz_Africa	Jazz Africa	dbo:artist	dbr:Foday_Musa_Suso
Jazz_Africa	Jazz Africa	dbo:artist	dbr:Herbie_Hancock
Sextant_(album)	Sextant (album)	dbo:artist	dbr:Herbie_Hancock
Cuckooland	Cuckooland	dbo:artist	dbr:Robert_Wyatt
Cupid_%26_Psyche_85	Cupid & Psyche 85	dbo:artist	dbr:Scritti_Politti
Empyrean_Isles	Empyrean Isles	dbo:artist	dbr:Herbie_Hancock
Streetnoise	Streetnoise	dbo:artist	dbr:Brian_Auger
Streetnoise	Streetnoise	dbo:artist	dbr:Julie_Driscoll
Extrapolation_(album)	Extrapolation (album)	dbo:artist	dbr:John_McLaughlin_(musician)
Possibilities	Possibilities	dbo:artist	dbr:Herbie_Hancock
Happy_Sad	Happy Sad	dbo:artist	dbr:Tim_Buckley
Big_Brother_(David_Bowie_song)	Big Brother (David Bowie song)	dbo:artist	dbr:David_Bowie
Question_and_Answer_(album)	Question and Answer (album)	dbo:artist	dbr:Pat_Metheny
Question_and_Answer_(album)	Question and Answer (album)	dbo:artist	dbr:Roy_Haynes
Question_and_Answer_(album)	Question and Answer (album)	dbo:artist	dbr:Dave_Holland
Mwandishi	Mwandishi	dbo:artist	dbr:Herbie_Hancock
The_Complete_In_a_Silent_Way_Sessions	The Complete In a Silent Way Sessions	dbo:artist	dbr:Miles_Davis
Art_Pepper_Meets_the_Rhythm_Section	Art Pepper Meets the Rhythm Section	dbo:artist	dbr:Art_Pepper
Friday_Night_in_San_Francisco	Friday Night in San Francisco	dbo:artist	dbr:Paco_de_Lucía
Friday_Night_in_San_Francisco	Friday Night in San Francisco	dbo:artist	dbr:Al_Di_Meola
Friday_Night_in_San_Francisco	Friday Night in San Francisco	dbo:artist	dbr:John_McLaughlin_(musician)
Spectrum_(Billy_Cobham_album)	Spectrum (Billy Cobham album)	dbo:artist	dbr:Billy_Cobham
Thrust_(album)	Thrust (album)	dbo:artist	dbr:Herbie_Hancock
Django_(album)	Django (album)	dbo:artist	dbr:Modern_Jazz_Quartet
Live_under_the_sky	Live under the sky	dbo:artist	dbr:V.S.O.P._(group)
Passion,_Grace_and_Fire	Passion, Grace and Fire	dbo:artist	dbr:Paco_de_Lucía
Passion,_Grace_and_Fire	Passion, Grace and Fire	dbo:artist	dbr:Al_Di_Meola
Passion,_Grace_and_Fire	Passion, Grace and Fire	dbo:artist	dbr:John_McLaughlin_(musician)
Eye_of_the_Beholder_(album)	Eye of the Beholder (album)	dbo:artist	dbr:Chick_Corea_Elektric_Band
%C3%9Cberjam	Überjam	dbo:artist	dbr:John_Scofield
Up_All_Night_(John_Scofield_album)	Up All Night (John Scofield album)	dbo:artist	dbr:John_Scofield
The_Guitar_Trio	The Guitar Trio	dbo:artist	dbr:Paco_de_Lucía
The_Guitar_Trio	The Guitar Trio	dbo:artist	dbr:Al_Di_Meola
The_Guitar_Trio	The Guitar Trio	dbo:artist	dbr:John_McLaughlin_(musician)
Live_in_Japan_(John_Coltrane_album)	Live in Japan (John Coltrane album)	dbo:artist	dbr:John_Coltrane
Enta_da_Stage	Enta da Stage	dbo:artist	dbr:Black_Moon_(group)
So_What_(Miles_Davis_composition)	So What (Miles Davis composition)	dbo:artist	dbr:Miles_Davis
Hi_Fly_(Peter_King_album)	Hi Fly (Peter King album)	dbo:artist	dbr:Peter_King_(saxophonist)
Bill_Evans_at_the_Montreux_Jazz_Festival	Bill Evans at the Montreux Jazz Festival	dbo:artist	dbr:Bill_Evans
Machismo_(album)	Machismo (album)	dbo:artist	dbr:Cameo_(band)
Together_Again_(Tony_Bennett_and_Bill_Evans_album)	Together Again (Tony Bennett and Bill Evans album)	dbo:artist	dbr:Tony_Bennett
Together_Again_(Tony_Bennett_and_Bill_Evans_album)	Together Again (Tony Bennett and Bill Evans album)	dbo:artist	dbr:Bill_Evans
Set_the_Booty_Up_Right	Set the Booty Up Right	dbo:artist	dbr:Fishbone
Art_Pepper_%2B_Eleven_%E2%80%93_Modern_Jazz_Classics	Art Pepper + Eleven – Modern Jazz Classics	dbo:artist	dbr:Art_Pepper
All_Blues	All Blues	dbo:artist	dbr:Miles_Davis
Grateful_Dead_Download_Series_Volume_5	Grateful Dead Download Series Volume 5	dbo:artist	dbr:Grateful_Dead
Reachin%27_(A_New_Refutation_of_Time_and_Space)	Reachin' (A New Refutation of Time and Space)	dbo:artist	dbr:Digable_Planets
Visions_of_the_Emerald_Beyond	Visions of the Emerald Beyond	dbo:artist	dbr:Mahavishnu_Orchestra
Counter_Culture_(album)	Counter Culture (album)	dbo:artist	dbr:Roy_Harper
Meditations_(John_Coltrane_album)	Meditations (John Coltrane album)	dbo:artist	dbr:John_Coltrane
An_Introduction_to_.....	An Introduction to .....	dbo:artist	dbr:Roy_Harper
In_Memory_of_Elizabeth_Reed	In Memory of Elizabeth Reed	dbo:artist	dbr:The_Allman_Brothers_Band
Intermodulation_(album)	Intermodulation (album)	dbo:artist	dbr:Jim_Hall_(musician)
Intermodulation_(album)	Intermodulation (album)	dbo:artist	dbr:Bill_Evans
Someday_My_Prince_Will_Come	Someday My Prince Will Come	dbo:artist	dbr:Adriana_Caselotti
Tones_for_Joan%27s_Bones	Tones for Joan's Bones	dbo:artist	dbr:Chick_Corea
The_Song_of_Singing	The Song of Singing	dbo:artist	dbr:Chick_Corea
Piano_Improvisations_Vol._1	Piano Improvisations Vol. 1	dbo:artist	dbr:Chick_Corea
Piano_Improvisations_Vol._2	Piano Improvisations Vol. 2	dbo:artist	dbr:Chick_Corea
My_Spanish_Heart	My Spanish Heart	dbo:artist	dbr:Chick_Corea
The_Mad_Hatter_(album)	The Mad Hatter (album)	dbo:artist	dbr:Chick_Corea
John_Coltrane_with_the_Red_Garland_Trio	John Coltrane with the Red Garland Trio	dbo:artist	dbr:John_Coltrane
An_Evening_with_Herbie_Hancock_%26_Chick_Corea:_In_Concert	An Evening with Herbie Hancock & Chick Corea: In Concert	dbo:artist	dbr:Herbie_Hancock
The_Leprechaun_(Chick_Corea_album)	The Leprechaun (Chick Corea album)	dbo:artist	dbr:Chick_Corea
Music_for_Two	Music for Two	dbo:artist	dbr:Béla_Fleck
Music_for_Two	Music for Two	dbo:artist	dbr:Edgar_Meyer
Agharta_(album)	Agharta (album)	dbo:artist	dbr:Miles_Davis
The_Derek_Trucks_Band_(album)	The Derek Trucks Band (album)	dbo:artist	dbr:The_Derek_Trucks_Band
Soul_Survivor_II	Soul Survivor II	dbo:artist	dbr:Pete_Rock
Miles_in_Berlin	Miles in Berlin	dbo:artist	dbr:Miles_Davis
Secret_Agent_(Chick_Corea_album)	Secret Agent (Chick Corea album)	dbo:artist	dbr:Chick_Corea
The_Quintet_(V.S.O.P._album)	The Quintet (V.S.O.P. album)	dbo:artist	dbr:V.S.O.P._(group)
Light_Years_(Chick_Corea_album)	Light Years (Chick Corea album)	dbo:artist	dbr:Chick_Corea_Elektric_Band
Friends_(Chick_Corea_album)	Friends (Chick Corea album)	dbo:artist	dbr:Chick_Corea
Whims_of_Chambers	Whims of Chambers	dbo:artist	dbr:Paul_Chambers
Ascension_(John_Coltrane_album)	Ascension (John Coltrane album)	dbo:artist	dbr:John_Coltrane
Metaphorical_Music	Metaphorical Music	dbo:artist	dbr:Nujabes
Time_Warp_(album)	Time Warp (album)	dbo:artist	dbr:Chick_Corea
Ascenseur_pour_l%27%C3%A9chafaud_(soundtrack)	Ascenseur pour l'échafaud (soundtrack)	dbo:artist	dbr:Miles_Davis
East-West_(The_Butterfield_Blues_Band_album)	East-West (The Butterfield Blues Band album)	dbo:artist	dbr:Paul_Butterfield
Tales_(album)	Tales (album)	dbo:artist	dbr:Marcus_Miller
Pangaea_(album)	Pangaea (album)	dbo:artist	dbr:Miles_Davis
We_Want_Miles	We Want Miles	dbo:artist	dbr:Miles_Davis
School_Days_(album)	School Days (album)	dbo:artist	dbr:Stanley_Clarke
Dropsonde_(album)	Dropsonde (album)	dbo:artist	dbr:Biosphere_(musician)
The_Cellar_Door_Sessions	The Cellar Door Sessions	dbo:artist	dbr:Miles_Davis
Future_Shock_(Herbie_Hancock_album)	Future Shock (Herbie Hancock album)	dbo:artist	dbr:Herbie_Hancock
Sound-System_(album)	Sound-System (album)	dbo:artist	dbr:Herbie_Hancock
Perfect_Machine	Perfect Machine	dbo:artist	dbr:Herbie_Hancock
The_New_Standard_(Herbie_Hancock_album)	The New Standard (Herbie Hancock album)	dbo:artist	dbr:Herbie_Hancock
Directions_in_Music:_Live_at_Massey_Hall	Directions in Music: Live at Massey Hall	dbo:artist	dbr:Roy_Hargrove
Directions_in_Music:_Live_at_Massey_Hall	Directions in Music: Live at Massey Hall	dbo:artist	dbr:Herbie_Hancock
Gershwin%27s_World	Gershwin's World	dbo:artist	dbr:Herbie_Hancock
1_%2B_1_(album)	1 + 1 (album)	dbo:artist	dbr:Herbie_Hancock
1_%2B_1_(album)	1 + 1 (album)	dbo:artist	dbr:Wayne_Shorter
A_Tribute_to_Miles	A Tribute to Miles	dbo:artist	dbr:Tony_Williams_(drummer)
A_Tribute_to_Miles	A Tribute to Miles	dbo:artist	dbr:Wallace_Roney
A_Tribute_to_Miles	A Tribute to Miles	dbo:artist	dbr:Ron_Carter
A_Tribute_to_Miles	A Tribute to Miles	dbo:artist	dbr:Herbie_Hancock
A_Tribute_to_Miles	A Tribute to Miles	dbo:artist	dbr:Wayne_Shorter
Quartet_(Herbie_Hancock_album)	Quartet (Herbie Hancock album)	dbo:artist	dbr:Herbie_Hancock
The_Lost_Trident_Sessions	The Lost Trident Sessions	dbo:artist	dbr:Mahavishnu_Orchestra
Lite_Me_Up	Lite Me Up	dbo:artist	dbr:Herbie_Hancock
Magic_Windows	Magic Windows	dbo:artist	dbr:Herbie_Hancock
Herbie_Hancock_Trio_(1982_album)	Herbie Hancock Trio (1982 album)	dbo:artist	dbr:Herbie_Hancock
Mr._Hands_(album)	Mr. Hands (album)	dbo:artist	dbr:Herbie_Hancock
Om_(John_Coltrane_album)	Om (John Coltrane album)	dbo:artist	dbr:John_Coltrane
Saxuality	Saxuality	dbo:artist	dbr:Candy_Dulfer
Live_in_Amsterdam_(Candy_Dulfer_album)	Live in Amsterdam (Candy Dulfer album)	dbo:artist	dbr:Candy_Dulfer
Smokin%27_at_the_Half_Note	Smokin' at the Half Note	dbo:artist	dbr:Wes_Montgomery
Smokin%27_at_the_Half_Note	Smokin' at the Half Note	dbo:artist	dbr:Wynton_Kelly
Celebrate_Freedom	Celebrate Freedom	dbo:artist	dbr:Phil_Driscoll
Live_at_the_Fillmore_East,_March_7,_1970:_It%27s_About_that_Time	Live at the Fillmore East, March 7, 1970: It's About that Time	dbo:artist	dbr:Miles_Davis
Miles_Davis_at_Fillmore	Miles Davis at Fillmore	dbo:artist	dbr:Miles_Davis
The_Complete_Jack_Johnson_Sessions	The Complete Jack Johnson Sessions	dbo:artist	dbr:Miles_Davis
Naima	Naima	dbo:artist	dbr:John_Coltrane
Sweet_Child	Sweet Child	dbo:artist	dbr:Pentangle_(band)
Coltrane%27s_Sound	Coltrane's Sound	dbo:artist	dbr:John_Coltrane
Miles_%26_Monk_at_Newport	Miles & Monk at Newport	dbo:artist	dbr:Thelonious_Monk
Miles_%26_Monk_at_Newport	Miles & Monk at Newport	dbo:artist	dbr:Miles_Davis
Lonesome,_On%27ry_and_Mean	Lonesome, On'ry and Mean	dbo:artist	dbr:Waylon_Jennings
A_Go_Go_(John_Scofield_album)	A Go Go (John Scofield album)	dbo:artist	dbr:John_Scofield
Electric_Tears	Electric Tears	dbo:artist	dbr:Buckethead
Saudades_(Trio_Beyond_album)	Saudades (Trio Beyond album)	dbo:artist	dbr:Trio_Beyond
Live_at_the_Fillmore_East_(Neil_Young_album)	Live at the Fillmore East (Neil Young album)	dbo:artist	dbr:Neil_Young
Live_at_the_Fillmore_East_(Neil_Young_album)	Live at the Fillmore East (Neil Young album)	dbo:artist	dbr:Crazy_Horse_(band)
The_Ozell_Tapes	The Ozell Tapes	dbo:artist	dbr:Marcus_Miller
Toshiko_Meets_Her_Old_Pals	Toshiko Meets Her Old Pals	dbo:artist	dbr:Toshiko_Akiyoshi
Freddie_Freeloader	Freddie Freeloader	dbo:artist	dbr:Miles_Davis
1961_%E2%80%93_Toshiko_Akiyoshi	1961 – Toshiko Akiyoshi	dbo:artist	dbr:Toshiko_Akiyoshi
Dedications_II	Dedications II	dbo:artist	dbr:Toshiko_Akiyoshi
Out_Louder	Out Louder	dbo:artist	dbr:Medeski_Martin_&_Wood
Remembering_Bud:_Cleopatra%27s_Dream	Remembering Bud: Cleopatra's Dream	dbo:artist	dbr:Toshiko_Akiyoshi
Dig_(Toshiko_Akiyoshi_album)	Dig (Toshiko Akiyoshi album)	dbo:artist	dbr:Toshiko_Akiyoshi
The_Pizza_Tapes	The Pizza Tapes	dbo:artist	dbr:Jerry_Garcia
The_Pizza_Tapes	The Pizza Tapes	dbo:artist	dbr:Tony_Rice
The_Pizza_Tapes	The Pizza Tapes	dbo:artist	dbr:David_Grisman
Sketches_of_Japan	Sketches of Japan	dbo:artist	dbr:Toshiko_Akiyoshi
The_Olatunji_Concert:_The_Last_Live_Recording	The Olatunji Concert: The Last Live Recording	dbo:artist	dbr:John_Coltrane
Thelonious_Monk_Quartet_with_John_Coltrane_at_Carnegie_Hall	Thelonious Monk Quartet with John Coltrane at Carnegie Hall	dbo:artist	dbr:Thelonious_Monk
Eat_the_Phikis	Eat the Phikis	dbo:artist	dbr:Elio_e_le_Storie_Tese
In_Concert,_Z%C3%BCrich,_October_28,_1979	In Concert, Zürich, October 28, 1979	dbo:artist	dbr:Chick_Corea
In_Concert,_Z%C3%BCrich,_October_28,_1979	In Concert, Zürich, October 28, 1979	dbo:artist	dbr:Gary_Burton
Like_Minds_(album)	Like Minds (album)	dbo:artist	dbr:Chick_Corea
Like_Minds_(album)	Like Minds (album)	dbo:artist	dbr:Pat_Metheny
Like_Minds_(album)	Like Minds (album)	dbo:artist	dbr:Gary_Burton
Like_Minds_(album)	Like Minds (album)	dbo:artist	dbr:Roy_Haynes
Like_Minds_(album)	Like Minds (album)	dbo:artist	dbr:Dave_Holland
Africa/Brass	Africa/Brass	dbo:artist	dbr:John_Coltrane
Point_of_View_(Cassandra_Wilson_album)	Point of View (Cassandra Wilson album)	dbo:artist	dbr:Cassandra_Wilson
Traveling_Miles	Traveling Miles	dbo:artist	dbr:Cassandra_Wilson
Bags_%26_Trane	Bags & Trane	dbo:artist	dbr:Milt_Jackson
Bags_%26_Trane	Bags & Trane	dbo:artist	dbr:John_Coltrane
Ballads_(John_Coltrane_album)	Ballads (John Coltrane album)	dbo:artist	dbr:John_Coltrane
Blue_Moods	Blue Moods	dbo:artist	dbr:Miles_Davis
The_Language_of_Life	The Language of Life	dbo:artist	dbr:Everything_but_the_Girl
Together_We%27re_Stranger	Together We're Stranger	dbo:artist	dbr:No-Man
Expression_(album)	Expression (album)	dbo:artist	dbr:John_Coltrane
Soultrane	Soultrane	dbo:artist	dbr:John_Coltrane
John_Coltrane_discography	John Coltrane discography	dbo:artist	dbr:John_Coltrane
The_Musings_of_Miles	The Musings of Miles	dbo:artist	dbr:Miles_Davis
Flamenco_Sketches	Flamenco Sketches	dbo:artist	dbr:Miles_Davis
Flamenco_Sketches	Flamenco Sketches	dbo:artist	dbr:Bill_Evans
Blue_in_Green	Blue in Green	dbo:artist	dbr:Miles_Davis
Blue_in_Green	Blue in Green	dbo:artist	dbr:Bill_Evans
Sun_City_(album)	Sun City (album)	dbo:artist	dbr:Artists_United_Against_Apartheid
Inventions_and_Dimensions	Inventions and Dimensions	dbo:artist	dbr:Herbie_Hancock
Zu_%26_Co.	Zu & Co.	dbo:artist	dbr:Zucchero_Fornaciari
Jean-Luc_Ponty_Experience_with_the_George_Duke_Trio	Jean-Luc Ponty Experience with the George Duke Trio	dbo:artist	dbr:Jean-Luc_Ponty
Bump_(album)	Bump (album)	dbo:artist	dbr:John_Scofield
Misterioso_(Thelonious_Monk_album)	Misterioso (Thelonious Monk album)	dbo:artist	dbr:Thelonious_Monk
EnRoute:_John_Scofield_Trio_LIVE	EnRoute: John Scofield Trio LIVE	dbo:artist	dbr:John_Scofield
Works_for_Me	Works for Me	dbo:artist	dbr:John_Scofield
John_Coltrane_and_Johnny_Hartman	John Coltrane and Johnny Hartman	dbo:artist	dbr:Johnny_Hartman
John_Coltrane_and_Johnny_Hartman	John Coltrane and Johnny Hartman	dbo:artist	dbr:John_Coltrane
The_Complete_1957_Riverside_Recordings	The Complete 1957 Riverside Recordings	dbo:artist	dbr:Thelonious_Monk
The_Complete_1957_Riverside_Recordings	The Complete 1957 Riverside Recordings	dbo:artist	dbr:John_Coltrane
Forecast:_Tomorrow	Forecast: Tomorrow	dbo:artist	dbr:Weather_Report
A_New_Perspective	A New Perspective	dbo:artist	dbr:Donald_Byrd
Ain%27t_a_Damn_Thing_Changed	Ain't a Damn Thing Changed	dbo:artist	dbr:Nice_&_Smooth
Nine_to_the_Universe	Nine to the Universe	dbo:artist	dbr:Jimi_Hendrix
Everybody_Digs_Bill_Evans	Everybody Digs Bill Evans	dbo:artist	dbr:Bill_Evans
Dakar_(album)	Dakar (album)	dbo:artist	dbr:John_Coltrane
Coltrane_(1957_album)	Coltrane (1957 album)	dbo:artist	dbr:John_Coltrane
Lush_Life_(John_Coltrane_album)	Lush Life (John Coltrane album)	dbo:artist	dbr:John_Coltrane
The_Last_Trane	The Last Trane	dbo:artist	dbr:John_Coltrane
The_Believer_(John_Coltrane_album)	The Believer (John Coltrane album)	dbo:artist	dbr:John_Coltrane
Settin%27_the_Pace	Settin' the Pace	dbo:artist	dbr:John_Coltrane
Black_Pearls	Black Pearls	dbo:artist	dbr:John_Coltrane
Standard_Coltrane	Standard Coltrane	dbo:artist	dbr:John_Coltrane
Bahia_(album)	Bahia (album)	dbo:artist	dbr:John_Coltrane
Coltrane_Jazz	Coltrane Jazz	dbo:artist	dbr:John_Coltrane
The_Avant-Garde_(album)	The Avant-Garde (album)	dbo:artist	dbr:Don_Cherry_(trumpeter)
The_Avant-Garde_(album)	The Avant-Garde (album)	dbo:artist	dbr:John_Coltrane
The_Heavyweight_Champion:_The_Complete_Atlantic_Recordings	The Heavyweight Champion: The Complete Atlantic Recordings	dbo:artist	dbr:John_Coltrane
Informal_Jazz	Informal Jazz	dbo:artist	dbr:Elmo_Hope
The_Prestige_Recordings	The Prestige Recordings	dbo:artist	dbr:John_Coltrane
Stardust_(John_Coltrane_album)	Stardust (John Coltrane album)	dbo:artist	dbr:John_Coltrane
Like_Sonny	Like Sonny	dbo:artist	dbr:John_Coltrane
Duke_Ellington_%26_John_Coltrane	Duke Ellington & John Coltrane	dbo:artist	dbr:Duke_Ellington
Duke_Ellington_%26_John_Coltrane	Duke Ellington & John Coltrane	dbo:artist	dbr:John_Coltrane
Coltrane_(1962_album)	Coltrane (1962 album)	dbo:artist	dbr:John_Coltrane
The_Major_Works_of_John_Coltrane	The Major Works of John Coltrane	dbo:artist	dbr:John_Coltrane
The_Ultimate_Adventure	The Ultimate Adventure	dbo:artist	dbr:Chick_Corea
Quiet_(album)	Quiet (album)	dbo:artist	dbr:John_Scofield
Groove_Elation	Groove Elation	dbo:artist	dbr:John_Scofield
Oh!_(ScoLoHoFo_album)	Oh! (ScoLoHoFo album)	dbo:artist	dbr:ScoLoHoFo
I_Can_See_Your_House_from_Here_(John_Scofield_and_Pat_Metheny_album)	I Can See Your House from Here (John Scofield and Pat Metheny album)	dbo:artist	dbr:John_Scofield
Man-Child	Man-Child	dbo:artist	dbr:Herbie_Hancock
Steady_Groovin%27	Steady Groovin'	dbo:artist	dbr:John_Scofield
Grace_Under_Pressure_(John_Scofield_album)	Grace Under Pressure (John Scofield album)	dbo:artist	dbr:John_Scofield
Liquid_Fire:_The_Best_of_John_Scofield	Liquid Fire: The Best of John Scofield	dbo:artist	dbr:John_Scofield
Still_Warm	Still Warm	dbo:artist	dbr:John_Scofield
Rough_House_(album)	Rough House (album)	dbo:artist	dbr:John_Scofield
What_We_Do	What We Do	dbo:artist	dbr:John_Scofield
Slo_Sco:The_Best_of_the_Ballads	Slo Sco:The Best of the Ballads	dbo:artist	dbr:John_Scofield
Blue_Matter	Blue Matter	dbo:artist	dbr:John_Scofield
Meant_to_Be_(John_Scofield_album)	Meant to Be (John Scofield album)	dbo:artist	dbr:John_Scofield
Time_on_My_Hands_(album)	Time on My Hands (album)	dbo:artist	dbr:John_Scofield
Pick_Hits_Live	Pick Hits Live	dbo:artist	dbr:John_Scofield
Loud_Jazz	Loud Jazz	dbo:artist	dbr:John_Scofield
Electric_Outlet	Electric Outlet	dbo:artist	dbr:John_Scofield
John_Scofield_Live	John Scofield Live	dbo:artist	dbr:John_Scofield
Bar_Talk	Bar Talk	dbo:artist	dbr:John_Scofield
Shinola_(John_Scofield_album)	Shinola (John Scofield album)	dbo:artist	dbr:John_Scofield
Out_Like_a_Light	Out Like a Light	dbo:artist	dbr:John_Scofield
East_Meets_West_(album)	East Meets West (album)	dbo:artist	dbr:John_Scofield
Flat_Out_(John_Scofield_album)	Flat Out (John Scofield album)	dbo:artist	dbr:John_Scofield
Trane%27s_Blues	Trane's Blues	dbo:artist	dbr:John_Coltrane
Coltrane_Live_at_Birdland	Coltrane Live at Birdland	dbo:artist	dbr:John_Coltrane
First_Meditations_(for_quartet)	First Meditations (for quartet)	dbo:artist	dbr:John_Coltrane
Jazz_Way_Out	Jazz Way Out	dbo:artist	dbr:Wilbur_Harden
Jazz_Way_Out	Jazz Way Out	dbo:artist	dbr:John_Coltrane
Countdown:_The_Savoy_Sessions	Countdown: The Savoy Sessions	dbo:artist	dbr:Wilbur_Harden
Countdown:_The_Savoy_Sessions	Countdown: The Savoy Sessions	dbo:artist	dbr:John_Coltrane
Dial_Africa:_The_Savoy_Sessions	Dial Africa: The Savoy Sessions	dbo:artist	dbr:Wilbur_Harden
Dial_Africa:_The_Savoy_Sessions	Dial Africa: The Savoy Sessions	dbo:artist	dbr:John_Coltrane
Gold_Coast_(album)	Gold Coast (album)	dbo:artist	dbr:Wilbur_Harden
Gold_Coast_(album)	Gold Coast (album)	dbo:artist	dbr:John_Coltrane
Tanganyika_Strut	Tanganyika Strut	dbo:artist	dbr:Wilbur_Harden
Tanganyika_Strut	Tanganyika Strut	dbo:artist	dbr:John_Coltrane
Best_of_John_Scofield	Best of John Scofield	dbo:artist	dbr:John_Scofield
My_Point_of_View	My Point of View	dbo:artist	dbr:Herbie_Hancock
Takin%27_Off	Takin' Off	dbo:artist	dbr:Herbie_Hancock
Moon_Beams	Moon Beams	dbo:artist	dbr:Bill_Evans
Scorched_(album)	Scorched (album)	dbo:artist	dbr:Mark-Anthony_Turnage
C-Note_(album)	C-Note (album)	dbo:artist	dbr:Prince_(musician)
C-Note_(album)	C-Note (album)	dbo:artist	dbr:The_New_Power_Generation
Expectations_(Keith_Jarrett_album)	Expectations (Keith Jarrett album)	dbo:artist	dbr:Keith_Jarrett
A_Funky_Thide_of_Sings	A Funky Thide of Sings	dbo:artist	dbr:Billy_Cobham
%27N_Gatz_We_Truss	'N Gatz We Truss	dbo:artist	dbr:South_Central_Cartel
Adventures_in_Radioland	Adventures in Radioland	dbo:artist	dbr:Mahavishnu_Orchestra
Zodiac_(soundtrack)	Zodiac (soundtrack)	dbo:artist	dbr:David_Shire
The_Beatnuts:_Street_Level	The Beatnuts: Street Level	dbo:artist	dbr:The_Beatnuts
The_Complete_Copenhagen_Concert	The Complete Copenhagen Concert	dbo:artist	dbr:John_Coltrane
Lanquidity	Lanquidity	dbo:artist	dbr:Sun_Ra
Red_Clay	Red Clay	dbo:artist	dbr:Freddie_Hubbard
Hub-Tones	Hub-Tones	dbo:artist	dbr:Freddie_Hubbard
Ezz-thetics	Ezz-thetics	dbo:artist	dbr:George_Russell_(composer)
Mahavishnu_(album)	Mahavishnu (album)	dbo:artist	dbr:Mahavishnu_Orchestra
Yesterdays_Universe	Yesterdays Universe	dbo:artist	dbr:Madlib
Feets,_Don%27t_Fail_Me_Now	Feets, Don't Fail Me Now	dbo:artist	dbr:Herbie_Hancock
Bold_Conceptions	Bold Conceptions	dbo:artist	dbr:Bob_James_(musician)
Infinity_(John_Coltrane_album)	Infinity (John Coltrane album)	dbo:artist	dbr:John_Coltrane
Three_Quartets	Three Quartets	dbo:artist	dbr:Chick_Corea
This_Is_an_EP_Release	This Is an EP Release	dbo:artist	dbr:Digital_Underground
A_Century_of_Song	A Century of Song	dbo:artist	dbr:La_Musique_Populaire
Play_(Chick_Corea_and_Bobby_McFerrin_album)	Play (Chick Corea and Bobby McFerrin album)	dbo:artist	dbr:Bobby_McFerrin
Camp_Meeting_(album)	Camp Meeting (album)	dbo:artist	dbr:Bruce_Hornsby
The_Classic_Quartet:_The_Complete_Impulse!_Recordings	The Classic Quartet: The Complete Impulse! Recordings	dbo:artist	dbr:John_Coltrane
Miles_%26_Quincy_Live_at_Montreux	Miles & Quincy Live at Montreux	dbo:artist	dbr:Miles_Davis
Miles_%26_Quincy_Live_at_Montreux	Miles & Quincy Live at Montreux	dbo:artist	dbr:Quincy_Jones
The_Complete_1961_Village_Vanguard_Recordings	The Complete 1961 Village Vanguard Recordings	dbo:artist	dbr:John_Coltrane
High_Step	High Step	dbo:artist	dbr:Paul_Chambers
High_Step	High Step	dbo:artist	dbr:John_Coltrane
Tenor_Conclave	Tenor Conclave	dbo:artist	dbr:Hank_Mobley
Tenor_Conclave	Tenor Conclave	dbo:artist	dbr:John_Coltrane
Tenor_Conclave	Tenor Conclave	dbo:artist	dbr:Al_Cohn
Interplay_for_2_Trumpets_and_2_Tenors	Interplay for 2 Trumpets and 2 Tenors	dbo:artist	dbr:Idrees_Sulieman
Interplay_for_2_Trumpets_and_2_Tenors	Interplay for 2 Trumpets and 2 Tenors	dbo:artist	dbr:Bobby_Jaspar
Interplay_for_2_Trumpets_and_2_Tenors	Interplay for 2 Trumpets and 2 Tenors	dbo:artist	dbr:John_Coltrane
Interplay_for_2_Trumpets_and_2_Tenors	Interplay for 2 Trumpets and 2 Tenors	dbo:artist	dbr:Webster_Young
The_Cats_(album)	The Cats (album)	dbo:artist	dbr:Tommy_Flanagan
Cattin%27_with_Coltrane_and_Quinichette	Cattin' with Coltrane and Quinichette	dbo:artist	dbr:John_Coltrane
Mal/2	Mal/2	dbo:artist	dbr:Mal_Waldron
A_Blowin%27_Session	A Blowin' Session	dbo:artist	dbr:Johnny_Griffin
Stereo_Drive	Stereo Drive	dbo:artist	dbr:Cecil_Taylor
Mainstream_1958	Mainstream 1958	dbo:artist	dbr:Wilbur_Harden
Alternate_Takes	Alternate Takes	dbo:artist	dbr:John_Coltrane
The_Coltrane_Legacy	The Coltrane Legacy	dbo:artist	dbr:John_Coltrane
The_Complete_Paris_Concerts	The Complete Paris Concerts	dbo:artist	dbr:John_Coltrane
Live_in_Stockholm_1961	Live in Stockholm 1961	dbo:artist	dbr:John_Coltrane
Afro_Blue_Impressions	Afro Blue Impressions	dbo:artist	dbr:John_Coltrane
The_European_Tour	The European Tour	dbo:artist	dbr:John_Coltrane
The_Complete_1962_Stockholm_Concert	The Complete 1962 Stockholm Concert	dbo:artist	dbr:John_Coltrane
Live_at_Birdland_1962	Live at Birdland 1962	dbo:artist	dbr:John_Coltrane
Bye_Bye_Blackbird_(John_Coltrane_album)	Bye Bye Blackbird (John Coltrane album)	dbo:artist	dbr:John_Coltrane
The_Paris_Concert_(John_Coltrane_album)	The Paris Concert (John Coltrane album)	dbo:artist	dbr:John_Coltrane
Live_in_Stockholm_1963	Live in Stockholm 1963	dbo:artist	dbr:John_Coltrane
Newport_%2763	Newport '63	dbo:artist	dbr:John_Coltrane
The_John_Coltrane_Quartet_Plays	The John Coltrane Quartet Plays	dbo:artist	dbr:John_Coltrane
Creation_(John_Coltrane_album)	Creation (John Coltrane album)	dbo:artist	dbr:John_Coltrane
Brazilia_(album)	Brazilia (album)	dbo:artist	dbr:John_Coltrane
Kulu_S%C3%A9_Mama	Kulu Sé Mama	dbo:artist	dbr:John_Coltrane
Living_Space_(album)	Living Space (album)	dbo:artist	dbr:John_Coltrane
Live_in_Seattle_(John_Coltrane_album)	Live in Seattle (John Coltrane album)	dbo:artist	dbr:John_Coltrane
Live_at_the_Half_Note:_One_Down,_One_Up	Live at the Half Note: One Down, One Up	dbo:artist	dbr:John_Coltrane
Live_in_Paris_(John_Coltrane_album)	Live in Paris (John Coltrane album)	dbo:artist	dbr:John_Coltrane
Live_in_Antibes	Live in Antibes	dbo:artist	dbr:John_Coltrane
Gleanings_(album)	Gleanings (album)	dbo:artist	dbr:John_Coltrane
The_Mastery_of_John_Coltrane,_Vol._2:_To_the_Beat_of_a_Different_Drum	The Mastery of John Coltrane, Vol. 2: To the Beat of a Different Drum	dbo:artist	dbr:John_Coltrane
New_Thing_at_Newport	New Thing at Newport	dbo:artist	dbr:John_Coltrane
New_Thing_at_Newport	New Thing at Newport	dbo:artist	dbr:Archie_Shepp
Selflessness:_Featuring_My_Favorite_Things	Selflessness: Featuring My Favorite Things	dbo:artist	dbr:John_Coltrane
Cosmic_Music	Cosmic Music	dbo:artist	dbr:Alice_Coltrane
Cosmic_Music	Cosmic Music	dbo:artist	dbr:John_Coltrane
Black_Beauty:_Live_at_the_Fillmore_West	Black Beauty: Live at the Fillmore West	dbo:artist	dbr:Miles_Davis
The_Essential_Santana	The Essential Santana	dbo:artist	dbr:Santana_(band)
The_Complete_Columbia_Recordings_of_Miles_Davis_with_John_Coltrane	The Complete Columbia Recordings of Miles Davis with John Coltrane	dbo:artist	dbr:Miles_Davis
The_Complete_Columbia_Recordings_of_Miles_Davis_with_John_Coltrane	The Complete Columbia Recordings of Miles Davis with John Coltrane	dbo:artist	dbr:John_Coltrane
Circle_in_the_Round	Circle in the Round	dbo:artist	dbr:Miles_Davis
Miles_Davis_Quintet_at_Peacock_Alley	Miles Davis Quintet at Peacock Alley	dbo:artist	dbr:Miles_Davis
The_Complete_Graz_Concert	The Complete Graz Concert	dbo:artist	dbr:John_Coltrane
The_Last_Giant:_Anthology	The Last Giant: Anthology	dbo:artist	dbr:John_Coltrane
Ken_Burns_Jazz:_John_Coltrane	Ken Burns Jazz: John Coltrane	dbo:artist	dbr:John_Coltrane
Nothing_to_Fear_(MC_Lars_album)	Nothing to Fear (MC Lars album)	dbo:artist	dbr:MC_Lars
Bob_Welch_Looks_at_Bop	Bob Welch Looks at Bop	dbo:artist	dbr:Bob_Welch_(musician)
Yesterdays_(1933_song)	Yesterdays (1933 song)	dbo:artist	dbr:Jerome_Kern
Tenor_Madness	Tenor Madness	dbo:artist	dbr:Sonny_Rollins
Sunlight_(album)	Sunlight (album)	dbo:artist	dbr:Herbie_Hancock
Hand_Jive_(album)	Hand Jive (album)	dbo:artist	dbr:John_Scofield
Amsterdam_Concert	Amsterdam Concert	dbo:artist	dbr:Miles_Davis
Crossings_(Herbie_Hancock_album)	Crossings (Herbie Hancock album)	dbo:artist	dbr:Herbie_Hancock
The_Columbia_Years_1955%E2%80%931985	The Columbia Years 1955–1985	dbo:artist	dbr:Miles_Davis
Paris_sous_les_bombes	Paris sous les bombes	dbo:artist	dbr:Suprême_NTM
In_Concert_(Miles_Davis_album)	In Concert (Miles Davis album)	dbo:artist	dbr:Miles_Davis
Free_(Marcus_Miller_album)	Free (Marcus Miller album)	dbo:artist	dbr:Marcus_Miller
The_Complete_On_the_Corner_Sessions	The Complete On the Corner Sessions	dbo:artist	dbr:Miles_Davis
You_Must_Believe_in_Spring	You Must Believe in Spring	dbo:artist	dbr:Bill_Evans
Miles_Davis_%26_Gil_Evans:_The_Complete_Columbia_Studio_Recordings	Miles Davis & Gil Evans: The Complete Columbia Studio Recordings	dbo:artist	dbr:Gil_Evans
Miles_Davis_%26_Gil_Evans:_The_Complete_Columbia_Studio_Recordings	Miles Davis & Gil Evans: The Complete Columbia Studio Recordings	dbo:artist	dbr:Miles_Davis
River:_The_Joni_Letters	River: The Joni Letters	dbo:artist	dbr:Herbie_Hancock
Straight_Life_(Freddie_Hubbard_album)	Straight Life (Freddie Hubbard album)	dbo:artist	dbr:Freddie_Hubbard
The_Complete_Miles_Davis_at_Montreux	The Complete Miles Davis at Montreux	dbo:artist	dbr:Miles_Davis
Rendezvous_in_New_York	Rendezvous in New York	dbo:artist	dbr:Chick_Corea
Monster_(Herbie_Hancock_album)	Monster (Herbie Hancock album)	dbo:artist	dbr:Herbie_Hancock
Live_Under_the_Sky	Live Under the Sky	dbo:artist	dbr:V.S.O.P._(group)
Water_Babies_(album)	Water Babies (album)	dbo:artist	dbr:Miles_Davis
Dark_Magus	Dark Magus	dbo:artist	dbr:Miles_Davis
Village_Life	Village Life	dbo:artist	dbr:Foday_Musa_Suso
Village_Life	Village Life	dbo:artist	dbr:Herbie_Hancock
My_Funny_Valentine_(album)	My Funny Valentine (album)	dbo:artist	dbr:Miles_Davis
Cool_Struttin%27	Cool Struttin'	dbo:artist	dbr:Sonny_Clark
Newk%27s_Time	Newk's Time	dbo:artist	dbr:Sonny_Rollins
George_Benson_discography	George Benson discography	dbo:artist	dbr:George_Benson
Inner_Worlds	Inner Worlds	dbo:artist	dbr:Mahavishnu_Orchestra
Cool_Bird	Cool Bird	dbo:artist	dbr:Charlie_Parker
Heaven_and_Earth_(Al_Jarreau_album)	Heaven and Earth (Al Jarreau album)	dbo:artist	dbr:Al_Jarreau
New_Amerykah_Part_One_(4th_World_War)	New Amerykah Part One (4th World War)	dbo:artist	dbr:Erykah_Badu
Empathy_(album)	Empathy (album)	dbo:artist	dbr:Shelly_Manne
Empathy_(album)	Empathy (album)	dbo:artist	dbr:Bill_Evans
A_Simple_Matter_of_Conviction	A Simple Matter of Conviction	dbo:artist	dbr:Bill_Evans
Speak_Like_a_Child_(album)	Speak Like a Child (album)	dbo:artist	dbr:Herbie_Hancock
The_Prisoner_(album)	The Prisoner (album)	dbo:artist	dbr:Herbie_Hancock
Conception_(album)	Conception (album)	dbo:artist	dbr:Stan_Getz
Conception_(album)	Conception (album)	dbo:artist	dbr:Lee_Konitz
Conception_(album)	Conception (album)	dbo:artist	dbr:Miles_Davis
Blue_Period_(album)	Blue Period (album)	dbo:artist	dbr:Miles_Davis
Dig_(Miles_Davis_album)	Dig (Miles Davis album)	dbo:artist	dbr:Miles_Davis
Wheelin%27_and_Dealin%27	Wheelin' and Dealin'	dbo:artist	dbr:Frank_Butler_(musician)
This_Meets_That	This Meets That	dbo:artist	dbr:John_Scofield
Fat_Albert_Rotunda	Fat Albert Rotunda	dbo:artist	dbr:Herbie_Hancock
VSOP_(album)	VSOP (album)	dbo:artist	dbr:Herbie_Hancock
Tempest_in_the_Colosseum	Tempest in the Colosseum	dbo:artist	dbr:V.S.O.P._(group)
Musicmagic	Musicmagic	dbo:artist	dbr:Return_to_Forever
Live_(Return_to_Forever_album)	Live (Return to Forever album)	dbo:artist	dbr:Return_to_Forever
Directstep	Directstep	dbo:artist	dbr:Herbie_Hancock
Jazz_Track	Jazz Track	dbo:artist	dbr:Miles_Davis
Flood_(Herbie_Hancock_album)	Flood (Herbie Hancock album)	dbo:artist	dbr:Herbie_Hancock
The_Piano_(Herbie_Hancock_album)	The Piano (Herbie Hancock album)	dbo:artist	dbr:Herbie_Hancock
Dedication_(Herbie_Hancock_album)	Dedication (Herbie Hancock album)	dbo:artist	dbr:Herbie_Hancock
Crystal_Silence	Crystal Silence	dbo:artist	dbr:Chick_Corea
Music_from_Siesta	Music from Siesta	dbo:artist	dbr:Marcus_Miller
Music_from_Siesta	Music from Siesta	dbo:artist	dbr:Miles_Davis
We_Will_Meet_Again	We Will Meet Again	dbo:artist	dbr:Bill_Evans
Emergency!_(album)	Emergency! (album)	dbo:artist	dbr:The_Tony_Williams_Lifetime
Elastic_Rock	Elastic Rock	dbo:artist	dbr:Nucleus_(band)
Miles_Davis_and_Horns	Miles Davis and Horns	dbo:artist	dbr:Miles_Davis
Ogunde_(song)	Ogunde (song)	dbo:artist	dbr:John_Coltrane
Lady_Day:_The_Complete_Billie_Holiday_on_Columbia_1933%E2%80%931944	Lady Day: The Complete Billie Holiday on Columbia 1933–1944	dbo:artist	dbr:Billie_Holiday
1958_Miles	1958 Miles	dbo:artist	dbr:Miles_Davis
Oscar_Peterson_at_the_Concertgebouw	Oscar Peterson at the Concertgebouw	dbo:artist	dbr:Oscar_Peterson
Rocky_Mountain_Jam	Rocky Mountain Jam	dbo:artist	dbr:Little_Feat
Marcus_(album)	Marcus (album)	dbo:artist	dbr:Marcus_Miller
Laid_Back_(album)	Laid Back (album)	dbo:artist	dbr:Gregg_Allman
Now_to_the_Future	Now to the Future	dbo:artist	dbr:FourPlay_String_Quartet
Magic_Touch_(Stanley_Jordan_album)	Magic Touch (Stanley Jordan album)	dbo:artist	dbr:Stanley_Jordan
Quincy_Jones_production_discography	Quincy Jones production discography	dbo:artist	dbr:Quincy_Jones
In_Person_Friday_and_Saturday_Nights_at_the_Blackhawk,_Complete	In Person Friday and Saturday Nights at the Blackhawk, Complete	dbo:artist	dbr:Miles_Davis_Quintet
In_Person_Friday_and_Saturday_Nights_at_the_Blackhawk,_Complete	In Person Friday and Saturday Nights at the Blackhawk, Complete	dbo:artist	dbr:Miles_Davis
Gettin%27_Together_(Art_Pepper_album)	Gettin' Together (Art Pepper album)	dbo:artist	dbr:Art_Pepper
To_the_Stars_(album)	To the Stars (album)	dbo:artist	dbr:Chick_Corea_Elektric_Band
Upon_This_Rock_(Joe_Farrell_album)	Upon This Rock (Joe Farrell album)	dbo:artist	dbr:Joe_Farrell
On_Green_Dolphin_Street_(album)	On Green Dolphin Street (album)	dbo:artist	dbr:Bill_Evans
How_My_Heart_Sings!	How My Heart Sings!	dbo:artist	dbr:Bill_Evans
Interplay_(Bill_Evans_album)	Interplay (Bill Evans album)	dbo:artist	dbr:Bill_Evans
Further_Conversations_with_Myself	Further Conversations with Myself	dbo:artist	dbr:Bill_Evans
California_Here_I_Come_(album)	California Here I Come (album)	dbo:artist	dbr:Bill_Evans
Coltrane_for_Lovers	Coltrane for Lovers	dbo:artist	dbr:John_Coltrane
Voyage_(Chick_Corea_album)	Voyage (Chick Corea album)	dbo:artist	dbr:Chick_Corea
Echoes_of_an_Era	Echoes of an Era	dbo:artist	dbr:Chaka_Khan
CK_(album)	CK (album)	dbo:artist	dbr:Chaka_Khan
The_Woman_I_Am	The Woman I Am	dbo:artist	dbr:Chaka_Khan
Epiphany:_The_Best_of_Chaka_Khan,_Vol._1	Epiphany: The Best of Chaka Khan, Vol. 1	dbo:artist	dbr:Chaka_Khan
Winter_in_America	Winter in America	dbo:artist	dbr:Brian_Jackson_(musician)
Winter_in_America	Winter in America	dbo:artist	dbr:Gil_Scott-Heron
Q%27s_Jook_Joint	Q's Jook Joint	dbo:artist	dbr:Quincy_Jones
Children%27s_Songs_(Chick_Corea_album)	Children's Songs (Chick Corea album)	dbo:artist	dbr:Chick_Corea
Trio_64	Trio 64	dbo:artist	dbr:Bill_Evans
Sting_discography	Sting discography	dbo:artist	dbr:Sting_(musician)
Sundance_(album)	Sundance (album)	dbo:artist	dbr:Chick_Corea
Delphi_I	Delphi I	dbo:artist	dbr:Chick_Corea
Tap_Step	Tap Step	dbo:artist	dbr:Chick_Corea
Again_and_Again_(album)	Again and Again (album)	dbo:artist	dbr:Chick_Corea
Round_Trip_(Sadao_Watanabe_album)	Round Trip (Sadao Watanabe album)	dbo:artist	dbr:Sadao_Watanabe_(musician)
Miles_in_Paris	Miles in Paris	dbo:artist	dbr:Miles_Davis
Steve_Lukather_discography	Steve Lukather discography	dbo:artist	dbr:Steve_Lukather
Thunder_(SMV_album)	Thunder (SMV album)	dbo:artist	dbr:SMV_(band)
One_(NoMeansNo_album)	One (NoMeansNo album)	dbo:artist	dbr:Nomeansno
Bird:_The_Complete_Charlie_Parker_on_Verve	Bird: The Complete Charlie Parker on Verve	dbo:artist	dbr:Charlie_Parker
Complete_Charlie_Parker_on_Dial	Complete Charlie Parker on Dial	dbo:artist	dbr:Charlie_Parker
Charlie_Parker_on_Dial	Charlie Parker on Dial	dbo:artist	dbr:Charlie_Parker
Time_Will_Pronounce	Time Will Pronounce	dbo:artist	dbr:Michael_Nyman
Bill_Frisell,_Ron_Carter,_Paul_Motian	Bill Frisell, Ron Carter, Paul Motian	dbo:artist	dbr:Bill_Frisell
Collectors%27_Items	Collectors' Items	dbo:artist	dbr:Miles_Davis
The_Straight_Horn_of_Steve_Lacy	The Straight Horn of Steve Lacy	dbo:artist	dbr:Steve_Lacy
Jazz_at_the_Plaza_Vol._I	Jazz at the Plaza Vol. I	dbo:artist	dbr:Miles_Davis
Sunrise_in_Different_Dimensions	Sunrise in Different Dimensions	dbo:artist	dbr:Sun_Ra
Miles!_Miles!_Miles!	Miles! Miles! Miles!	dbo:artist	dbr:Miles_Davis
Super_Nova_(Wayne_Shorter_album)	Super Nova (Wayne Shorter album)	dbo:artist	dbr:Wayne_Shorter
The_Individualism_of_Gil_Evans	The Individualism of Gil Evans	dbo:artist	dbr:Gil_Evans
Guinnevere	Guinnevere	dbo:artist	dbr:Crosby,_Stills,_Nash_&_Young
Live_at_the_Village_Vanguard_(Michel_Petrucciani_album)	Live at the Village Vanguard (Michel Petrucciani album)	dbo:artist	dbr:Michel_Petrucciani
Herbie_Hancock_discography	Herbie Hancock discography	dbo:artist	dbr:Herbie_Hancock
Seven_Standards	Seven Standards	dbo:artist	dbr:Anthony_Braxton
Selim_Sivad:_A_Tribute_to_Miles_Davis	Selim Sivad: A Tribute to Miles Davis	dbo:artist	dbr:World_Saxophone_Quartet
Vagina_Diner	Vagina Diner	dbo:artist	dbr:Akinyele_(rapper)
Poppin%27_(album)	Poppin' (album)	dbo:artist	dbr:Hank_Mobley
The_Cooker	The Cooker	dbo:artist	dbr:Lee_Morgan
Devotion_(John_McLaughlin_album)	Devotion (John McLaughlin album)	dbo:artist	dbr:John_McLaughlin_(musician)
Electric_Dreams_(John_McLaughlin_album)	Electric Dreams (John McLaughlin album)	dbo:artist	dbr:John_McLaughlin_(musician)
At_Newport_1958	At Newport 1958	dbo:artist	dbr:Miles_Davis
Convergence_(Dave_Douglas_album)	Convergence (Dave Douglas album)	dbo:artist	dbr:Dave_Douglas_(trumpeter)
Strange_Liberation	Strange Liberation	dbo:artist	dbr:Dave_Douglas_(trumpeter)
CoreaHancock	CoreaHancock	dbo:artist	dbr:Chick_Corea
CoreaHancock	CoreaHancock	dbo:artist	dbr:Herbie_Hancock
Keystone_(album)	Keystone (album)	dbo:artist	dbr:Dave_Douglas_(trumpeter)
Electric_Guitarist	Electric Guitarist	dbo:artist	dbr:John_McLaughlin_(musician)
Of_Love_and_Peace	Of Love and Peace	dbo:artist	dbr:Larry_Young_(musician)
Moto_Grosso_Feio	Moto Grosso Feio	dbo:artist	dbr:Wayne_Shorter
The_Fabulous_Chi-Ali	The Fabulous Chi-Ali	dbo:artist	dbr:Chi_Ali
The_Jazz_Message_of_Hank_Mobley	The Jazz Message of Hank Mobley	dbo:artist	dbr:Hank_Mobley
Provision_(album)	Provision (album)	dbo:artist	dbr:Scritti_Politti
Alone_(Bill_Evans_album)	Alone (Bill Evans album)	dbo:artist	dbr:Bill_Evans
The_Solo_Sessions,_Vol._1	The Solo Sessions, Vol. 1	dbo:artist	dbr:Bill_Evans
At_Shelly%27s_Manne-Hole	At Shelly's Manne-Hole	dbo:artist	dbr:Bill_Evans
Affinity_(Bill_Evans_album)	Affinity (Bill Evans album)	dbo:artist	dbr:Bill_Evans
New_Conversations	New Conversations	dbo:artist	dbr:Bill_Evans
I_Will_Say_Goodbye	I Will Say Goodbye	dbo:artist	dbr:Bill_Evans
Trio_%2765	Trio '65	dbo:artist	dbr:Bill_Evans
Bill_Evans_Trio_with_Symphony_Orchestra	Bill Evans Trio with Symphony Orchestra	dbo:artist	dbr:Bill_Evans
Bill_Evans_at_Town_Hall	Bill Evans at Town Hall	dbo:artist	dbr:Bill_Evans
What%27s_New_(Bill_Evans_album)	What's New (Bill Evans album)	dbo:artist	dbr:Bill_Evans
The_Bill_Evans_Album	The Bill Evans Album	dbo:artist	dbr:Bill_Evans
Herbie_Hancock_Trio_(1977_album)	Herbie Hancock Trio (1977 album)	dbo:artist	dbr:Herbie_Hancock
Death_Wish_(soundtrack)	Death Wish (soundtrack)	dbo:artist	dbr:Herbie_Hancock
Blow-Up_(soundtrack)	Blow-Up (soundtrack)	dbo:artist	dbr:The_Yardbirds
Blow-Up_(soundtrack)	Blow-Up (soundtrack)	dbo:artist	dbr:Herbie_Hancock
Crosscurrents_(album)	Crosscurrents (album)	dbo:artist	dbr:Lee_Konitz
Crosscurrents_(album)	Crosscurrents (album)	dbo:artist	dbr:Bill_Evans
Quintessence_(Bill_Evans_album)	Quintessence (Bill Evans album)	dbo:artist	dbr:Bill_Evans
Alone_(Again)	Alone (Again)	dbo:artist	dbr:Bill_Evans
Quiet_Now	Quiet Now	dbo:artist	dbr:Bill_Evans
From_Left_to_Right	From Left to Right	dbo:artist	dbr:Bill_Evans
Intuition_(Bill_Evans_album)	Intuition (Bill Evans album)	dbo:artist	dbr:Bill_Evans
Waltz_for_Debby_(1964_album)	Waltz for Debby (1964 album)	dbo:artist	dbr:Monica_Zetterlund
Waltz_for_Debby_(1964_album)	Waltz for Debby (1964 album)	dbo:artist	dbr:Bill_Evans
Round_Midnight_(soundtrack)	Round Midnight (soundtrack)	dbo:artist	dbr:Herbie_Hancock
A_Monstrous_Psychedelic_Bubble_Exploding_in_Your_Mind:_Volume_1	A Monstrous Psychedelic Bubble Exploding in Your Mind: Volume 1	dbo:artist	dbr:The_Future_Sound_of_London
Glenn_Miller_discography	Glenn Miller discography	dbo:artist	dbr:Glenn_Miller
Extensions_(McCoy_Tyner_album)	Extensions (McCoy Tyner album)	dbo:artist	dbr:McCoy_Tyner
The_Paris_Concert_(Oscar_Peterson_album)	The Paris Concert (Oscar Peterson album)	dbo:artist	dbr:Oscar_Peterson
Major_Changes	Major Changes	dbo:artist	dbr:Frank_Morgan_(musician)
Major_Changes	Major Changes	dbo:artist	dbr:McCoy_Tyner
My_Goal%27s_Beyond	My Goal's Beyond	dbo:artist	dbr:John_McLaughlin_(musician)
Solar:_Live_at_Sweet_Basil	Solar: Live at Sweet Basil	dbo:artist	dbr:McCoy_Tyner
Face_to_Face_(Oscar_Peterson_and_Freddie_Hubbard_album)	Face to Face (Oscar Peterson and Freddie Hubbard album)	dbo:artist	dbr:Oscar_Peterson
Four_%26_More	Four & More	dbo:artist	dbr:Miles_Davis
The_Kicker_(Joe_Henderson_album)	The Kicker (Joe Henderson album)	dbo:artist	dbr:Joe_Henderson
Four_(Joe_Henderson_album)	Four (Joe Henderson album)	dbo:artist	dbr:Joe_Henderson
Straight,_No_Chaser_(Joe_Henderson_album)	Straight, No Chaser (Joe Henderson album)	dbo:artist	dbr:Joe_Henderson
The_Standard_(album)	The Standard (album)	dbo:artist	dbr:Take_6
The_Rise_and_Fall_of_Charlie_Parker	The Rise and Fall of Charlie Parker	dbo:artist	dbr:Charlie_Parker
If_You_Could_See_Me_Now_(Oscar_Peterson_album)	If You Could See Me Now (Oscar Peterson album)	dbo:artist	dbr:Oscar_Peterson
Live_at_Donte%27s_(Joe_Pass_album)	Live at Donte's (Joe Pass album)	dbo:artist	dbr:Joe_Pass
Introducing_Kenny_Garrett	Introducing Kenny Garrett	dbo:artist	dbr:Kenny_Garrett
Things_We_Like	Things We Like	dbo:artist	dbr:Jack_Bruce
Piety_Street	Piety Street	dbo:artist	dbr:John_Scofield
Equinox_(standard)	Equinox (standard)	dbo:artist	dbr:John_Coltrane
The_Living_Return	The Living Return	dbo:artist	dbr:Swing_Out_Sister
Sonny%27s_Crib	Sonny's Crib	dbo:artist	dbr:Sonny_Clark
He_Was..._She_Was..._You_Was..._We_Was...	He Was... She Was... You Was... We Was...	dbo:artist	dbr:Roger_Chapman
Straight,_No_Chaser_(composition)	Straight, No Chaser (composition)	dbo:artist	dbr:Thelonious_Monk
Baby_Won%27t_You_Please_Come_Home	Baby Won't You Please Come Home	dbo:artist	dbr:Clarence_Williams_(musician)
Billie%27s_Bounce	Billie's Bounce	dbo:artist	dbr:Charlie_Parker
Big_Band_(album)	Big Band (album)	dbo:artist	dbr:Joe_Henderson
So_Near,_So_Far_(Musings_for_Miles)	So Near, So Far (Musings for Miles)	dbo:artist	dbr:Joe_Henderson
Music_of_Bill_Evans	Music of Bill Evans	dbo:artist	dbr:Kronos_Quartet
Bags%27_Groove_(composition)	Bags' Groove (composition)	dbo:artist	dbr:Miles_Davis
Bob_Brookmeyer_and_Friends	Bob Brookmeyer and Friends	dbo:artist	dbr:Bob_Brookmeyer
Waltz_for_Debby_(song)	Waltz for Debby (song)	dbo:artist	dbr:Bill_Evans
Two_Hand_Band	Two Hand Band	dbo:artist	dbr:Pat_Donohue
Ritual:_The_Modern_Jazz_Messengers	Ritual: The Modern Jazz Messengers	dbo:artist	dbr:Art_Blakey
Ritual:_The_Modern_Jazz_Messengers	Ritual: The Modern Jazz Messengers	dbo:artist	dbr:The_Jazz_Messengers
MMTC:_Monk,_Miles,_Trane_%26_Cannon	MMTC: Monk, Miles, Trane & Cannon	dbo:artist	dbr:Freddie_Hubbard
At_Jazz_Jamboree_Warszawa_%2791:_A_Tribute_to_Miles	At Jazz Jamboree Warszawa '91: A Tribute to Miles	dbo:artist	dbr:Freddie_Hubbard
Live_Around_the_World_(Miles_Davis_album)	Live Around the World (Miles Davis album)	dbo:artist	dbr:Miles_Davis
The_Heart_of_Things	The Heart of Things	dbo:artist	dbr:John_McLaughlin_(musician)
Tokyo_Live_(John_McLaughlin_album)	Tokyo Live (John McLaughlin album)	dbo:artist	dbr:John_McLaughlin_(musician)
Captain_Marvel_(album)	Captain Marvel (album)	dbo:artist	dbr:Stan_Getz
Returns_(album)	Returns (album)	dbo:artist	dbr:Return_to_Forever
Joe_Farrell_Quartet	Joe Farrell Quartet	dbo:artist	dbr:Joe_Farrell
Moon_Germs	Moon Germs	dbo:artist	dbr:Joe_Farrell
Outback_(album)	Outback (album)	dbo:artist	dbr:Joe_Farrell
Penny_Arcade_(album)	Penny Arcade (album)	dbo:artist	dbr:Joe_Farrell
Night_Dancing	Night Dancing	dbo:artist	dbr:Joe_Farrell
Seven_Steps:_The_Complete_Columbia_Recordings_of_Miles_Davis_1963%E2%80%931964	Seven Steps: The Complete Columbia Recordings of Miles Davis 1963–1964	dbo:artist	dbr:Miles_Davis
The_Complete_Studio_Recordings_of_The_Miles_Davis_Quintet_1965%E2%80%931968	The Complete Studio Recordings of The Miles Davis Quintet 1965–1968	dbo:artist	dbr:Miles_Davis
Love_Is_the_Answer_(album)	Love Is the Answer (album)	dbo:artist	dbr:Barbra_Streisand
George_Russell_Sextet_at_the_Five_Spot	George Russell Sextet at the Five Spot	dbo:artist	dbr:George_Russell_(composer)
Quietude	Quietude	dbo:artist	dbr:Lenny_Breau
Live_at_Bourbon_St.	Live at Bourbon St.	dbo:artist	dbr:Lenny_Breau
Live_at_Donte%27s_(Lenny_Breau_album)	Live at Donte's (Lenny Breau album)	dbo:artist	dbr:Lenny_Breau
Dog_Years_in_the_Fourth_Ring	Dog Years in the Fourth Ring	dbo:artist	dbr:Rahsaan_Roland_Kirk
Mar_West	Mar West	dbo:artist	dbr:Tony_Rice
Parallel_Realities	Parallel Realities	dbo:artist	dbr:Jack_DeJohnette
Devlin_(album)	Devlin (album)	dbo:artist	dbr:Tony_Rice
Now%27s_the_Time_(Sonny_Rollins_album)	Now's the Time (Sonny Rollins album)	dbo:artist	dbr:Sonny_Rollins
Sonny_Rollins_with_the_Modern_Jazz_Quartet	Sonny Rollins with the Modern Jazz Quartet	dbo:artist	dbr:Sonny_Rollins
Sings_Standards	Sings Standards	dbo:artist	dbr:Cassandra_Wilson
Portrait_of_Cannonball	Portrait of Cannonball	dbo:artist	dbr:Cannonball_Adderley
Kelly_Blue	Kelly Blue	dbo:artist	dbr:Wynton_Kelly
Cannonball_Adderley_Quintet_in_Chicago	Cannonball Adderley Quintet in Chicago	dbo:artist	dbr:Cannonball_Adderley
Que_Alegria	Que Alegria	dbo:artist	dbr:John_McLaughlin_(musician)
One_for_All_(Kazumi_Watanabe_album)	One for All (Kazumi Watanabe album)	dbo:artist	dbr:Kazumi_Watanabe
Kylyn	Kylyn	dbo:artist	dbr:Kazumi_Watanabe
Living_Time	Living Time	dbo:artist	dbr:Bill_Evans
Sunrise_(Robben_Ford_album)	Sunrise (Robben Ford album)	dbo:artist	dbr:Robben_Ford
So_What_(George_Russell_album)	So What (George Russell album)	dbo:artist	dbr:George_Russell_(composer)
The_New_Crystal_Silence	The New Crystal Silence	dbo:artist	dbr:Chick_Corea
George_Russell_Sextet_in_K.C.	George Russell Sextet in K.C.	dbo:artist	dbr:George_Russell_(composer)
The_London_Concert_(George_Russell_album)	The London Concert (George Russell album)	dbo:artist	dbr:George_Russell_(composer)
The_80th_Birthday_Concert	The 80th Birthday Concert	dbo:artist	dbr:George_Russell_(composer)
1995_(Screaming_Headless_Torsos_album)	1995 (Screaming Headless Torsos album)	dbo:artist	dbr:Screaming_Headless_Torsos
Movin%27_Along	Movin' Along	dbo:artist	dbr:Wes_Montgomery
Fusion!_Wes_Montgomery_with_Strings	Fusion! Wes Montgomery with Strings	dbo:artist	dbr:Wes_Montgomery
Portrait_of_Wes	Portrait of Wes	dbo:artist	dbr:Wes_Montgomery
Jazz_in_the_Garden	Jazz in the Garden	dbo:artist	dbr:Stanley_Clarke
Jazz_in_the_Garden	Jazz in the Garden	dbo:artist	dbr:Lenny_White
Miles_Davis:_The_Complete_Columbia_Album_Collection	Miles Davis: The Complete Columbia Album Collection	dbo:artist	dbr:Miles_Davis
Betty_Davis_(album)	Betty Davis (album)	dbo:artist	dbr:Betty_Davis
Miles_in_Tokyo	Miles in Tokyo	dbo:artist	dbr:Miles_Davis
Bye_Bye_Blackbird_(Keith_Jarrett_album)	Bye Bye Blackbird (Keith Jarrett album)	dbo:artist	dbr:Keith_Jarrett
New_Bottle_Old_Wine	New Bottle Old Wine	dbo:artist	dbr:Gil_Evans
Zawinul_(album)	Zawinul (album)	dbo:artist	dbr:Joe_Zawinul
Where_Fortune_Smiles	Where Fortune Smiles	dbo:artist	dbr:John_Surman
Where_Fortune_Smiles	Where Fortune Smiles	dbo:artist	dbr:Karl_Berger
Where_Fortune_Smiles	Where Fortune Smiles	dbo:artist	dbr:Stu_Martin_(drummer)
Where_Fortune_Smiles	Where Fortune Smiles	dbo:artist	dbr:Dave_Holland
Where_Fortune_Smiles	Where Fortune Smiles	dbo:artist	dbr:John_McLaughlin_(musician)
Live_%26_More_(Marcus_Miller_album)	Live & More (Marcus Miller album)	dbo:artist	dbr:Marcus_Miller
Black_Messiah_(album)	Black Messiah (album)	dbo:artist	dbr:D'Angelo
My_Beautiful_Dark_Twisted_Fantasy	My Beautiful Dark Twisted Fantasy	dbo:artist	dbr:Kanye_West
Minor_Elegance	Minor Elegance	dbo:artist	dbr:Joe_Diorio
Last_Nite_(Larry_Carlton_album)	Last Nite (Larry Carlton album)	dbo:artist	dbr:Larry_Carlton
The_Ivory_Hunters	The Ivory Hunters	dbo:artist	dbr:Bill_Evans
Nirvana_(Herbie_Mann_and_the_Bill_Evans_Trio_album)	Nirvana (Herbie Mann and the Bill Evans Trio album)	dbo:artist	dbr:Herbie_Mann
Loose_Blues	Loose Blues	dbo:artist	dbr:Bill_Evans
Chick_Corea_Akoustic_Band	Chick Corea Akoustic Band	dbo:artist	dbr:Chick_Corea
Jazzhouse	Jazzhouse	dbo:artist	dbr:Bill_Evans
You%27re_Gonna_Hear_from_Me_(album)	You're Gonna Hear from Me (album)	dbo:artist	dbr:Bill_Evans
Montreux_II	Montreux II	dbo:artist	dbr:Bill_Evans
Montreux_III	Montreux III	dbo:artist	dbr:Bill_Evans
Chet_(Chet_Baker_album)	Chet (Chet Baker album)	dbo:artist	dbr:Chet_Baker
Re:_Person_I_Knew	Re: Person I Knew	dbo:artist	dbr:Bill_Evans
Since_We_Met	Since We Met	dbo:artist	dbr:Bill_Evans
The_Tokyo_Concert	The Tokyo Concert	dbo:artist	dbr:Bill_Evans
Half_Moon_Bay_(album)	Half Moon Bay (album)	dbo:artist	dbr:Bill_Evans
Symbiosis_(album)	Symbiosis (album)	dbo:artist	dbr:Bill_Evans
The_Paris_Concert:_Edition_One	The Paris Concert: Edition One	dbo:artist	dbr:Bill_Evans
The_Paris_Concert:_Edition_Two	The Paris Concert: Edition Two	dbo:artist	dbr:Bill_Evans
The_Enchantment	The Enchantment	dbo:artist	dbr:Chick_Corea
The_Enchantment	The Enchantment	dbo:artist	dbr:Béla_Fleck
Homecoming_(Bill_Evans_album)	Homecoming (Bill Evans album)	dbo:artist	dbr:Bill_Evans
Blue_in_Green:_The_Concert_in_Canada	Blue in Green: The Concert in Canada	dbo:artist	dbr:Bill_Evans
Tribute_(Keith_Jarrett_album)	Tribute (Keith Jarrett album)	dbo:artist	dbr:Keith_Jarrett
At_the_Deer_Head_Inn	At the Deer Head Inn	dbo:artist	dbr:Keith_Jarrett
Universal_Syncopations	Universal Syncopations	dbo:artist	dbr:Miroslav_Vitouš
My_Foolish_Heart_(Keith_Jarrett_album)	My Foolish Heart (Keith Jarrett album)	dbo:artist	dbr:Keith_Jarrett
Getting_Sentimental	Getting Sentimental	dbo:artist	dbr:Bill_Evans
The_Imagine_Project	The Imagine Project	dbo:artist	dbr:Herbie_Hancock
Time_Remembered_(album)	Time Remembered (album)	dbo:artist	dbr:Bill_Evans
The_Antidote_(Ronny_Jordan_album)	The Antidote (Ronny Jordan album)	dbo:artist	dbr:Ronny_Jordan
The_Last_Waltz:_The_Final_Recordings	The Last Waltz: The Final Recordings	dbo:artist	dbr:Bill_Evans
Consecration:_The_Final_Recordings_Part_2	Consecration: The Final Recordings Part 2	dbo:artist	dbr:Bill_Evans
The_Alternative_Wes_Montgomery	The Alternative Wes Montgomery	dbo:artist	dbr:Wes_Montgomery
Natural_Elements_(Shakti_album)	Natural Elements (Shakti album)	dbo:artist	dbr:Shakti_(band)
A_Handful_of_Beauty	A Handful of Beauty	dbo:artist	dbr:Shakti_(band)
Live_at_the_Blue_Note_(Chick_Corea_album)	Live at the Blue Note (Chick Corea album)	dbo:artist	dbr:Chick_Corea
Change_(Chick_Corea_album)	Change (Chick Corea album)	dbo:artist	dbr:Chick_Corea
Further_Adventures_of_Jimmy_and_Wes	Further Adventures of Jimmy and Wes	dbo:artist	dbr:Jimmy_Smith_(musician)
Further_Adventures_of_Jimmy_and_Wes	Further Adventures of Jimmy and Wes	dbo:artist	dbr:Wes_Montgomery
Jazz_at_the_Plaza_Vol._II	Jazz at the Plaza Vol. II	dbo:artist	dbr:Duke_Ellington
Bird_on_52nd_St.	Bird on 52nd St.	dbo:artist	dbr:Charlie_Parker
Rich_in_London	Rich in London	dbo:artist	dbr:Buddy_Rich
The_Art_of_Three	The Art of Three	dbo:artist	dbr:Billy_Cobham
Freddie_Freeloader_(album)	Freddie Freeloader (album)	dbo:artist	dbr:Jon_Hendricks
Wynton_Kelly!	Wynton Kelly!	dbo:artist	dbr:Wynton_Kelly
Blues_on_Purpose	Blues on Purpose	dbo:artist	dbr:Wynton_Kelly
Chant_(Donald_Byrd_album)	Chant (Donald Byrd album)	dbo:artist	dbr:Donald_Byrd
Royal_Flush_(album)	Royal Flush (album)	dbo:artist	dbr:Donald_Byrd
Free_Form	Free Form	dbo:artist	dbr:Donald_Byrd
The_Creeper_(album)	The Creeper (album)	dbo:artist	dbr:Donald_Byrd
The_Vinyl_Conflict	The Vinyl Conflict	dbo:artist	dbr:Slayer
Sunday_Mornin%27_(album)	Sunday Mornin' (album)	dbo:artist	dbr:Grant_Green
Beyond_the_Blue_Horizon	Beyond the Blue Horizon	dbo:artist	dbr:George_Benson
No_Blues_(album)	No Blues (album)	dbo:artist	dbr:Horace_Parlan
Musically_Yours	Musically Yours	dbo:artist	dbr:Horace_Parlan
The_Maestro_(album)	The Maestro (album)	dbo:artist	dbr:Horace_Parlan
Dig_It!	Dig It!	dbo:artist	dbr:Red_Garland
Super_Hits_(Miles_Davis_album)	Super Hits (Miles Davis album)	dbo:artist	dbr:Miles_Davis
Down_with_It!	Down with It!	dbo:artist	dbr:Blue_Mitchell
75_(album)	75 (album)	dbo:artist	dbr:Joe_Zawinul
The_Thing_to_Do_(album)	The Thing to Do (album)	dbo:artist	dbr:Blue_Mitchell
Boss_Horn	Boss Horn	dbo:artist	dbr:Blue_Mitchell
The_Other_Side_of_Round_Midnight	The Other Side of Round Midnight	dbo:artist	dbr:Dexter_Gordon
Swedish_Schnapps_(album)	Swedish Schnapps (album)	dbo:artist	dbr:Charlie_Parker
Triplicate_(album)	Triplicate (album)	dbo:artist	dbr:Dave_Holland
Drives_(Lonnie_Smith_album)	Drives (Lonnie Smith album)	dbo:artist	dbr:Lonnie_Smith_(jazz_musician)
Young_Man_with_a_Horn_(Miles_Davis_album)	Young Man with a Horn (Miles Davis album)	dbo:artist	dbr:Miles_Davis
Merry-Go-Round_(album)	Merry-Go-Round (album)	dbo:artist	dbr:Elvin_Jones
Flute_By-Laws	Flute By-Laws	dbo:artist	dbr:Hubert_Laws
Introducing_Kenny_Cox	Introducing Kenny Cox	dbo:artist	dbr:Kenny_Cox
So_Beautiful_or_So_What	So Beautiful or So What	dbo:artist	dbr:Paul_Simon
The_Glow_of_Love	The Glow of Love	dbo:artist	dbr:Change_(band)
The_Best_of_John_Coltrane	The Best of John Coltrane	dbo:artist	dbr:John_Coltrane
Bass_on_Top	Bass on Top	dbo:artist	dbr:Paul_Chambers
Givin%27_It_Up	Givin' It Up	dbo:artist	dbr:George_Benson
Live_at_Newport_1958_%26_1963	Live at Newport 1958 & 1963	dbo:artist	dbr:Miles_Davis
Chasin%27_the_Bird_(Miles_Davis_album)	Chasin' the Bird (Miles Davis album)	dbo:artist	dbr:Miles_Davis
Crosswinds_(Billy_Cobham_album)	Crosswinds (Billy Cobham album)	dbo:artist	dbr:Billy_Cobham
Panthalassa:_The_Music_of_Miles_Davis_1969%E2%80%931974	Panthalassa: The Music of Miles Davis 1969–1974	dbo:artist	dbr:Miles_Davis
Panthalassa:_The_Remixes	Panthalassa: The Remixes	dbo:artist	dbr:Miles_Davis
The_Essential_Miles_Davis	The Essential Miles Davis	dbo:artist	dbr:Miles_Davis
Circling_In	Circling In	dbo:artist	dbr:Chick_Corea
Circulus_(album)	Circulus (album)	dbo:artist	dbr:Chick_Corea
The_Legendary_Prestige_Quintet_Sessions	The Legendary Prestige Quintet Sessions	dbo:artist	dbr:Miles_Davis
Lights_of_Endangered_Species	Lights of Endangered Species	dbo:artist	dbr:Matthew_Good
Tower_(album)	Tower (album)	dbo:artist	dbr:Circle_(band)
Booker_Little_(album)	Booker Little (album)	dbo:artist	dbr:Booker_Little
Booker_Little_4_and_Max_Roach	Booker Little 4 and Max Roach	dbo:artist	dbr:Booker_Little
Delphi_II_%26_III	Delphi II & III	dbo:artist	dbr:Chick_Corea
Quiet_Nights_(Miles_Davis_and_Gil_Evans_album)	Quiet Nights (Miles Davis and Gil Evans album)	dbo:artist	dbr:Gil_Evans
Quiet_Nights_(Miles_Davis_and_Gil_Evans_album)	Quiet Nights (Miles Davis and Gil Evans album)	dbo:artist	dbr:Miles_Davis
There%27s_a_Riot_Goin%27_On	There's a Riot Goin' On	dbo:artist	dbr:Sly_and_the_Family_Stone
Pure_Hank	Pure Hank	dbo:artist	dbr:Hank_Williams,_Jr.
The_Gate_(Kurt_Elling_album)	The Gate (Kurt Elling album)	dbo:artist	dbr:Kurt_Elling
The_Stanley_Clarke_Band	The Stanley Clarke Band	dbo:artist	dbr:Stanley_Clarke
Remembering_the_Moment	Remembering the Moment	dbo:artist	dbr:David_Friesen
Remembering_the_Moment	Remembering the Moment	dbo:artist	dbr:Jim_Pepper
Remembering_the_Moment	Remembering the Moment	dbo:artist	dbr:Julian_Priester
Mal,_Dance_and_Soul	Mal, Dance and Soul	dbo:artist	dbr:Mal_Waldron
Chick_Corea_Featuring_Lionel_Hampton	Chick Corea Featuring Lionel Hampton	dbo:artist	dbr:Chick_Corea
My_Dear_Family	My Dear Family	dbo:artist	dbr:Mal_Waldron
To_the_One	To the One	dbo:artist	dbr:John_McLaughlin_(musician)
Proof_Positive_(album)	Proof Positive (album)	dbo:artist	dbr:J._J._Johnson
Queen_of_the_Organ	Queen of the Organ	dbo:artist	dbr:Shirley_Scott
Bitches_Brew_Live	Bitches Brew Live	dbo:artist	dbr:Miles_Davis
1969_Miles_%E2%80%93_Festiva_De_Juan_Pins	1969 Miles – Festiva De Juan Pins	dbo:artist	dbr:Miles_Davis
Miles_Davis%27_Greatest_Hits	Miles Davis' Greatest Hits	dbo:artist	dbr:Miles_Davis
Directions_(Miles_Davis_album)	Directions (Miles Davis album)	dbo:artist	dbr:Miles_Davis
Sounding_Point	Sounding Point	dbo:artist	dbr:Julian_Lage
Live_from_Los_Angeles	Live from Los Angeles	dbo:artist	dbr:Oliver_Nelson
Soundsigns	Soundsigns	dbo:artist	dbr:Dewey_Redman
The_Chick_Corea_Elektric_Band_(album)	The Chick Corea Elektric Band (album)	dbo:artist	dbr:Chick_Corea
Industrial_Zen	Industrial Zen	dbo:artist	dbr:John_McLaughlin_(musician)
Thieves_and_Poets	Thieves and Poets	dbo:artist	dbr:John_McLaughlin_(musician)
The_Heart_of_Things:_Live_in_Paris	The Heart of Things: Live in Paris	dbo:artist	dbr:John_McLaughlin_(musician)
Belo_Horizonte_(album)	Belo Horizonte (album)	dbo:artist	dbr:John_McLaughlin_(musician)
Bang!_Zoom	Bang! Zoom	dbo:artist	dbr:Bobby_McFerrin
Live_at_the_Royal_Festival_Hall_(John_McLaughlin_Trio_album)	Live at the Royal Festival Hall (John McLaughlin Trio album)	dbo:artist	dbr:John_McLaughlin_(musician)
You_Won%27t_Forget_Me	You Won't Forget Me	dbo:artist	dbr:Shirley_Horn
Streams_of_Expression	Streams of Expression	dbo:artist	dbr:Joe_Lovano
First_Miles	First Miles	dbo:artist	dbr:Miles_Davis
Live_at_the_1963_Monterey_Jazz_Festival	Live at the 1963 Monterey Jazz Festival	dbo:artist	dbr:Miles_Davis
Sarah_Vaughan_in_Hi-Fi	Sarah Vaughan in Hi-Fi	dbo:artist	dbr:Sarah_Vaughan
Piano_Player_(album)	Piano Player (album)	dbo:artist	dbr:Bill_Evans
Birdland_1951	Birdland 1951	dbo:artist	dbr:Miles_Davis
Miles_%26_Coltrane	Miles & Coltrane	dbo:artist	dbr:Miles_Davis
Basic_Miles:_The_Classic_Performances_of_Miles_Davis	Basic Miles: The Classic Performances of Miles Davis	dbo:artist	dbr:Miles_Davis
Cool_%26_Collected	Cool & Collected	dbo:artist	dbr:Miles_Davis
The_Miles_Davis_Collection,_Vol._1:_12_Sides_of_Miles	The Miles Davis Collection, Vol. 1: 12 Sides of Miles	dbo:artist	dbr:Miles_Davis
Forever_Miles_Davis	Forever Miles Davis	dbo:artist	dbr:Miles_Davis
Beautiful_Ballads_%26_Love_Songs_(Miles_Davis_album)	Beautiful Ballads & Love Songs (Miles Davis album)	dbo:artist	dbr:Miles_Davis
Ballads_and_Blues_(Miles_Davis_album)	Ballads and Blues (Miles Davis album)	dbo:artist	dbr:Miles_Davis
Highlights_from_the_Plugged_Nickel	Highlights from the Plugged Nickel	dbo:artist	dbr:Miles_Davis
Love_Songs_(Miles_Davis_album)	Love Songs (Miles Davis album)	dbo:artist	dbr:Miles_Davis
Sensory_Overdrive	Sensory Overdrive	dbo:artist	dbr:Michael_Monroe
Bop_for_Miles	Bop for Miles	dbo:artist	dbr:Mark_Murphy_(singer)
Phantasies_(album)	Phantasies (album)	dbo:artist	dbr:Jaki_Byard
Two_Tenors	Two Tenors	dbo:artist	dbr:Hank_Mobley
Two_Tenors	Two Tenors	dbo:artist	dbr:John_Coltrane
Quartets:_Live_at_the_Village_Vanguard	Quartets: Live at the Village Vanguard	dbo:artist	dbr:Joe_Lovano
A_Moment%27s_Peace	A Moment's Peace	dbo:artist	dbr:John_Scofield
A_Garland_of_Red	A Garland of Red	dbo:artist	dbr:Red_Garland
Turn_Out_the_Stars:_The_Final_Village_Vanguard_Recordings	Turn Out the Stars: The Final Village Vanguard Recordings	dbo:artist	dbr:Bill_Evans
Letter_to_Evan	Letter to Evan	dbo:artist	dbr:Bill_Evans
Turn_Out_the_Stars	Turn Out the Stars	dbo:artist	dbr:Bill_Evans
Touchstone_(album)	Touchstone (album)	dbo:artist	dbr:Chick_Corea
Trio_Music	Trio Music	dbo:artist	dbr:Chick_Corea
Inside_Out_(Chick_Corea_album)	Inside Out (Chick Corea album)	dbo:artist	dbr:Chick_Corea_Elektric_Band
Beneath_the_Mask	Beneath the Mask	dbo:artist	dbr:Chick_Corea
Expressions_(Chick_Corea_album)	Expressions (Chick Corea album)	dbo:artist	dbr:Chick_Corea
Alive_(Chick_Corea_album)	Alive (Chick Corea album)	dbo:artist	dbr:Chick_Corea
Reincarnation_of_a_Love_Bird	Reincarnation of a Love Bird	dbo:artist	dbr:Paul_Motian
Flight_of_the_Blue_Jay	Flight of the Blue Jay	dbo:artist	dbr:Paul_Motian
The_Africa/Brass_Sessions,_Volume_2	The Africa/Brass Sessions, Volume 2	dbo:artist	dbr:John_Coltrane
Thirteen_(Robert_Miles_album)	Thirteen (Robert Miles album)	dbo:artist	dbr:Robert_Miles
Miles_Davis_at_Carnegie_Hall	Miles Davis at Carnegie Hall	dbo:artist	dbr:Miles_Davis
Joey_DeFrancesco_discography	Joey DeFrancesco discography	dbo:artist	dbr:Joey_DeFrancesco
Three_Pieces_for_Blues_Band_and_Symphony_Orchestra	Three Pieces for Blues Band and Symphony Orchestra	dbo:artist	dbr:Siegel–Schwall_Band
A.R.C._(album)	A.R.C. (album)	dbo:artist	dbr:Chick_Corea
A.R.C._(album)	A.R.C. (album)	dbo:artist	dbr:Barry_Altschul
A.R.C._(album)	A.R.C. (album)	dbo:artist	dbr:Dave_Holland
Paris_Concert_(Circle_album)	Paris Concert (Circle album)	dbo:artist	dbr:Circle_(jazz_band)
Have_Some_Fun:_Live_at_Ungano%27s	Have Some Fun: Live at Ungano's	dbo:artist	dbr:The_Stooges
Eon_(album)	Eon (album)	dbo:artist	dbr:Richie_Beirach
Emerald_Tears	Emerald Tears	dbo:artist	dbr:Dave_Holland
Duet_(Gary_Burton_%26_Chick_Corea_album)	Duet (Gary Burton & Chick Corea album)	dbo:artist	dbr:Chick_Corea
Duet_(Gary_Burton_%26_Chick_Corea_album)	Duet (Gary Burton & Chick Corea album)	dbo:artist	dbr:Gary_Burton
Dark_Beauty	Dark Beauty	dbo:artist	dbr:Kenny_Drew
Solo_Concert	Solo Concert	dbo:artist	dbr:Ralph_Towner
Lyric_Suite_for_Sextet	Lyric Suite for Sextet	dbo:artist	dbr:Chick_Corea
Lyric_Suite_for_Sextet	Lyric Suite for Sextet	dbo:artist	dbr:Gary_Burton
Septet_(album)	Septet (album)	dbo:artist	dbr:Chick_Corea
Skate_Board_Park	Skate Board Park	dbo:artist	dbr:Joe_Farrell
Slide_Show_(album)	Slide Show (album)	dbo:artist	dbr:Ralph_Towner
Trio_Music_Live_in_Europe	Trio Music Live in Europe	dbo:artist	dbr:Chick_Corea
Is_(album)	Is (album)	dbo:artist	dbr:Chick_Corea
I_Remember_Miles	I Remember Miles	dbo:artist	dbr:Shirley_Horn
Live_in_Europe_1967:_The_Bootleg_Series_Vol._1	Live in Europe 1967: The Bootleg Series Vol. 1	dbo:artist	dbr:Miles_Davis
Third_Plane	Third Plane	dbo:artist	dbr:Ron_Carter
Making_Music_(Zakir_Hussain_album)	Making Music (Zakir Hussain album)	dbo:artist	dbr:Zakir_Hussain_(musician)
A_Molde_Concert	A Molde Concert	dbo:artist	dbr:Arild_Andersen
Chiaroscuro_(Ralph_Towner_album)	Chiaroscuro (Ralph Towner album)	dbo:artist	dbr:Ralph_Towner
Lazy_Highways	Lazy Highways	dbo:artist	dbr:The_Fauves
Lofty_Fake_Anagram	Lofty Fake Anagram	dbo:artist	dbr:Gary_Burton
Paris_Encounter	Paris Encounter	dbo:artist	dbr:Gary_Burton
Paris_Encounter	Paris Encounter	dbo:artist	dbr:Stéphane_Grappelli
Beauty_Is_a_Rare_Thing	Beauty Is a Rare Thing	dbo:artist	dbr:Ornette_Coleman
In_Angel_City	In Angel City	dbo:artist	dbr:Charlie_Haden
The_Montreal_Tapes:_with_Gonzalo_Rubalcaba_and_Paul_Motian	The Montreal Tapes: with Gonzalo Rubalcaba and Paul Motian	dbo:artist	dbr:Charlie_Haden
Donna_Lee_(album)	Donna Lee (album)	dbo:artist	dbr:Anthony_Braxton
Inner_Space_(album)	Inner Space (album)	dbo:artist	dbr:Chick_Corea
Born_Free_(Milt_Jackson_album)	Born Free (Milt Jackson album)	dbo:artist	dbr:Milt_Jackson
Sunflower_(Milt_Jackson_album)	Sunflower (Milt Jackson album)	dbo:artist	dbr:Milt_Jackson
The_Laws_of_Jazz	The Laws of Jazz	dbo:artist	dbr:Hubert_Laws
Blues_Farm	Blues Farm	dbo:artist	dbr:Ron_Carter
All_Blues_(album)	All Blues (album)	dbo:artist	dbr:Ron_Carter
Spanish_Blue_(album)	Spanish Blue (album)	dbo:artist	dbr:Ron_Carter
The_Kolexxxion	The Kolexxxion	dbo:artist	dbr:DJ_Premier
More_Jazz_Meets_the_Symphony	More Jazz Meets the Symphony	dbo:artist	dbr:Lalo_Schifrin
Firebird:_Jazz_Meets_the_Symphony_No._3	Firebird: Jazz Meets the Symphony No. 3	dbo:artist	dbr:Lalo_Schifrin
Mr._P.C._(composition)	Mr. P.C. (composition)	dbo:artist	dbr:John_Coltrane
The_Mastery_of_John_Coltrane,_Vol._3:_Jupiter_Variation	The Mastery of John Coltrane, Vol. 3: Jupiter Variation	dbo:artist	dbr:John_Coltrane
The_Mastery_of_John_Coltrane,_Vol._4:_Trane%27s_Modes	The Mastery of John Coltrane, Vol. 4: Trane's Modes	dbo:artist	dbr:John_Coltrane
The_Mastery_of_John_Coltrane,_Vol._1:_Feelin%27_Good	The Mastery of John Coltrane, Vol. 1: Feelin' Good	dbo:artist	dbr:John_Coltrane
Max_%2B_Dizzy:_Paris_1989	Max + Dizzy: Paris 1989	dbo:artist	dbr:Dizzy_Gillespie
Max_%2B_Dizzy:_Paris_1989	Max + Dizzy: Paris 1989	dbo:artist	dbr:Max_Roach
Solar_(Red_Garland_album)	Solar (Red Garland album)	dbo:artist	dbr:Red_Garland
The_In_Sound	The In Sound	dbo:artist	dbr:Eddie_Harris
New_Mann_at_Newport	New Mann at Newport	dbo:artist	dbr:Herbie_Mann
Seven_Steps_to_Heaven_(composition)	Seven Steps to Heaven (composition)	dbo:artist	dbr:Miles_Davis
Joshua_(composition)	Joshua (composition)	dbo:artist	dbr:Miles_Davis
Four_(composition)	Four (composition)	dbo:artist	dbr:Miles_Davis
Duo_Live_in_Concert	Duo Live in Concert	dbo:artist	dbr:Niels-Henning_Ørsted_Pedersen
Duo_Live_in_Concert	Duo Live in Concert	dbo:artist	dbr:Kenny_Drew
Farmer%27s_Market_(album)	Farmer's Market (album)	dbo:artist	dbr:Art_Farmer
Live_at_the_Half-Note	Live at the Half-Note	dbo:artist	dbr:Art_Farmer
Great_Scott!_(1958_Shirley_Scott_album)	Great Scott! (1958 Shirley Scott album)	dbo:artist	dbr:Shirley_Scott
Travelin%27_Light_(Shirley_Scott_%26_Kenny_Burrell_album)	Travelin' Light (Shirley Scott & Kenny Burrell album)	dbo:artist	dbr:Shirley_Scott
Travelin%27_Light_(Shirley_Scott_%26_Kenny_Burrell_album)	Travelin' Light (Shirley Scott & Kenny Burrell album)	dbo:artist	dbr:Kenny_Burrell
Fantastic_Frank_Strozier	Fantastic Frank Strozier	dbo:artist	dbr:Frank_Strozier
Blues_Everywhere	Blues Everywhere	dbo:artist	dbr:Shirley_Scott
Skylark_(Shirley_Scott_album)	Skylark (Shirley Scott album)	dbo:artist	dbr:Shirley_Scott
Jawbreakers_(album)	Jawbreakers (album)	dbo:artist	dbr:Harry_Edison
Jawbreakers_(album)	Jawbreakers (album)	dbo:artist	dbr:Eddie_"Lockjaw"_Davis
Zu_%26_Co_live_at_the_Royal_Albert_Hall	Zu & Co live at the Royal Albert Hall	dbo:artist	dbr:Zucchero_Fornaciari
Live_at_the_Jazz%27Inn	Live at the Jazz'Inn	dbo:artist	dbr:Jaki_Byard
Laborintus_II_(2012_recording)	Laborintus II (2012 recording)	dbo:artist	dbr:Mike_Patton
Laborintus_II_(2012_recording)	Laborintus II (2012 recording)	dbo:artist	dbr:Ictus_Ensemble
Great_Ideas_of_Western_Mann	Great Ideas of Western Mann	dbo:artist	dbr:Herbie_Mann
2_Trumpets	2 Trumpets	dbo:artist	dbr:Art_Farmer
2_Trumpets	2 Trumpets	dbo:artist	dbr:Donald_Byrd
The_P.C._Blues	The P.C. Blues	dbo:artist	dbr:Red_Garland
Red_Garland_Revisited!	Red Garland Revisited!	dbo:artist	dbr:Red_Garland
The_Chant_(album)	The Chant (album)	dbo:artist	dbr:Sam_Jones_(musician)
Blues_for_Dracula	Blues for Dracula	dbo:artist	dbr:Philly_Joe_Jones
The_Teddy_Charles_Tentet	The Teddy Charles Tentet	dbo:artist	dbr:Teddy_Charles
It%27s_Time_for_Dave_Pike	It's Time for Dave Pike	dbo:artist	dbr:Dave_Pike
Solo_Tribute:_Keith_Jarrett_%E2%80%93_The_100th_Performance_in_Japan	Solo Tribute: Keith Jarrett – The 100th Performance in Japan	dbo:artist	dbr:Keith_Jarrett
Summer_Night:_Live	Summer Night: Live	dbo:artist	dbr:Chick_Corea_Akoustic_Band
Jammin%27_in_Hi_Fi_with_Gene_Ammons	Jammin' in Hi Fi with Gene Ammons	dbo:artist	dbr:Gene_Ammons
Everything_We_Love	Everything We Love	dbo:artist	dbr:Thorgeir_Stubø
Everything_We_Love	Everything We Love	dbo:artist	dbr:Doug_Raney
Music_Spoken_Here	Music Spoken Here	dbo:artist	dbr:John_McLaughlin_(musician)
Tune-Up!	Tune-Up!	dbo:artist	dbr:Sonny_Stitt
Ten_Freedom_Summers	Ten Freedom Summers	dbo:artist	dbr:Wadada_Leo_Smith
All_Night_Long_(Kenny_Burrell_album)	All Night Long (Kenny Burrell album)	dbo:artist	dbr:Kenny_Burrell
Gods_and_Monsters_(Gary_Lucas_album)	Gods and Monsters (Gary Lucas album)	dbo:artist	dbr:Gary_Lucas
Jazz_(Tenacious_D_album)	Jazz (Tenacious D album)	dbo:artist	dbr:Tenacious_D
Living_Black!	Living Black!	dbo:artist	dbr:Charles_Earland
Out_of_This_World_(Pepper_Adams_Donald_Byrd_Quintet_album)	Out of This World (Pepper Adams Donald Byrd Quintet album)	dbo:artist	dbr:Pepper_Adams
Boppin%27_%26_Burnin%27	Boppin' & Burnin'	dbo:artist	dbr:Don_Patterson_(organist)
Brothers-4	Brothers-4	dbo:artist	dbr:Don_Patterson_(organist)
Tune_Up!_(album)	Tune Up! (album)	dbo:artist	dbr:Don_Patterson_(organist)
Introducing_Eric_Kloss	Introducing Eric Kloss	dbo:artist	dbr:Eric_Kloss
Love_and_All_That_Jazz	Love and All That Jazz	dbo:artist	dbr:Eric_Kloss
Love_and_All_That_Jazz	Love and All That Jazz	dbo:artist	dbr:Richard_Holmes_(organist)
Grits_%26_Gravy	Grits & Gravy	dbo:artist	dbr:Eric_Kloss
In_the_Land_of_the_Giants	In the Land of the Giants	dbo:artist	dbr:Eric_Kloss
Poetry_of_Fire	Poetry of Fire	dbo:artist	dbr:Iceburn
For_Lady	For Lady	dbo:artist	dbr:Webster_Young
After_the_Rain_(John_McLaughlin_album)	After the Rain (John McLaughlin album)	dbo:artist	dbr:John_McLaughlin_(musician)
The_Promise_(John_McLaughlin_album)	The Promise (John McLaughlin album)	dbo:artist	dbr:John_McLaughlin_(musician)
Cheek_to_Cheek_(album)	Cheek to Cheek (album)	dbo:artist	dbr:Lady_Gaga
Cheek_to_Cheek_(album)	Cheek to Cheek (album)	dbo:artist	dbr:Tony_Bennett
Straight_Ahead_(Art_Blakey_album)	Straight Ahead (Art Blakey album)	dbo:artist	dbr:Art_Blakey
Straight_Ahead_(Art_Blakey_album)	Straight Ahead (Art Blakey album)	dbo:artist	dbr:The_Jazz_Messengers
Focused	Focused	dbo:artist	dbr:Billy_Cobham
%C3%9Cberjam_Deux	Überjam Deux	dbo:artist	dbr:John_Scofield
Generation_(Dexter_Gordon_album)	Generation (Dexter Gordon album)	dbo:artist	dbr:Dexter_Gordon
West_Coast_Live_(album)	West Coast Live (album)	dbo:artist	dbr:Chet_Baker
Chris_Botti_in_Boston	Chris Botti in Boston	dbo:artist	dbr:Chris_Botti
Chet_Baker_in_New_York	Chet Baker in New York	dbo:artist	dbr:Chet_Baker
Chet_Baker_in_Milan	Chet Baker in Milan	dbo:artist	dbr:Chet_Baker
Hot_House_(Gary_Burton_and_Chick_Corea_album)	Hot House (Gary Burton and Chick Corea album)	dbo:artist	dbr:Chick_Corea
Hot_House_(Gary_Burton_and_Chick_Corea_album)	Hot House (Gary Burton and Chick Corea album)	dbo:artist	dbr:Gary_Burton
Woody_Shaw:_The_Complete_Columbia_Albums_Collection	Woody Shaw: The Complete Columbia Albums Collection	dbo:artist	dbr:Woody_Shaw
In_My_Own_Sweet_Way	In My Own Sweet Way	dbo:artist	dbr:Woody_Shaw
As_One_(Richard_Davis_album)	As One (Richard Davis album)	dbo:artist	dbr:Richard_Davis_(bassist)
Fancy_Free_(Richard_Davis_album)	Fancy Free (Richard Davis album)	dbo:artist	dbr:Richard_Davis_(bassist)
Interchange_(album)	Interchange (album)	dbo:artist	dbr:Pat_Martino
The_Mothership_Returns	The Mothership Returns	dbo:artist	dbr:Return_to_Forever
My_Place_(album)	My Place (album)	dbo:artist	dbr:Monika_Borzym
Now_Here_This	Now Here This	dbo:artist	dbr:John_McLaughlin_(musician)
Total_Eclipse_(Billy_Cobham_album)	Total Eclipse (Billy Cobham album)	dbo:artist	dbr:Billy_Cobham
The_Vigil	The Vigil	dbo:artist	dbr:Chick_Corea
Within_a_Song	Within a Song	dbo:artist	dbr:John_Abercrombie_(guitarist)
Orvieto_(album)	Orvieto (album)	dbo:artist	dbr:Chick_Corea
Orvieto_(album)	Orvieto (album)	dbo:artist	dbr:Stefano_Bollani
What%27s_Inside	What's Inside	dbo:artist	dbr:Joan_Armatrading
Rewind_That	Rewind That	dbo:artist	dbr:Christian_Scott
Topaz_(Erik_Friedlander_album)	Topaz (Erik Friedlander album)	dbo:artist	dbr:Erik_Friedlander
Ocean_of_Sound	Ocean of Sound	dbo:artist	dbr:Compilation_album
Art_of_the_Trio_4:_Back_at_the_Vanguard	Art of the Trio 4: Back at the Vanguard	dbo:artist	dbr:Brad_Mehldau
Dave%27s_Picks_Volume_9	Dave's Picks Volume 9	dbo:artist	dbr:Grateful_Dead
Sonic_Explorations	Sonic Explorations	dbo:artist	dbr:Matthew_Shipp
The_Complete_RCA_Victor_Recordings	The Complete RCA Victor Recordings	dbo:artist	dbr:Dizzy_Gillespie
Play_All_Night:_Live_at_the_Beacon_Theatre_1992	Play All Night: Live at the Beacon Theatre 1992	dbo:artist	dbr:The_Allman_Brothers_Band
Points_(Matthew_Shipp_album)	Points (Matthew Shipp album)	dbo:artist	dbr:Matthew_Shipp
Stolen_Moments_(Lee_Ritenour_album)	Stolen Moments (Lee Ritenour album)	dbo:artist	dbr:Lee_Ritenour
The_Nearness_of_You_(Houston_Person_album)	The Nearness of You (Houston Person album)	dbo:artist	dbr:Houston_Person
Remember_Shakti_(album)	Remember Shakti (album)	dbo:artist	dbr:Remember_Shakti
Time_Remembered:_John_McLaughlin_Plays_Bill_Evans	Time Remembered: John McLaughlin Plays Bill Evans	dbo:artist	dbr:John_McLaughlin_(musician)
Native_Sense_-_The_New_Duets	Native Sense - The New Duets	dbo:artist	dbr:Chick_Corea
Native_Sense_-_The_New_Duets	Native Sense - The New Duets	dbo:artist	dbr:Gary_Burton
Magic_Labyrinth	Magic Labyrinth	dbo:artist	dbr:Marc_Johnson_(musician)
Remember_Shakti_%E2%80%93_The_Believer	Remember Shakti – The Believer	dbo:artist	dbr:Remember_Shakti
Remember_Shakti_%E2%80%93_Saturday_Night_in_Bombay	Remember Shakti – Saturday Night in Bombay	dbo:artist	dbr:Remember_Shakti
Flower_Hour	Flower Hour	dbo:artist	dbr:Pat_Metheny
The_New_Sounds	The New Sounds	dbo:artist	dbr:Miles_Davis
The_Compositions_Of_Al_Cohn	The Compositions Of Al Cohn	dbo:artist	dbr:Miles_Davis
Miles_Davis_Quartet_(album)	Miles Davis Quartet (album)	dbo:artist	dbr:Miles_Davis
Candy_(Chet_Baker_album)	Candy (Chet Baker album)	dbo:artist	dbr:Chet_Baker
Miles_Davis_All-Star_Sextet_(album)	Miles Davis All-Star Sextet (album)	dbo:artist	dbr:Miles_Davis
Somewhere_(Keith_Jarrett_album)	Somewhere (Keith Jarrett album)	dbo:artist	dbr:Keith_Jarrett
Miles_Davis_Quintet_(album)	Miles Davis Quintet (album)	dbo:artist	dbr:Miles_Davis
Miles_Davis_with_Sonny_Rollins	Miles Davis with Sonny Rollins	dbo:artist	dbr:Miles_Davis
Miles_Davis_All_Stars,_Volume_1	Miles Davis All Stars, Volume 1	dbo:artist	dbr:Miles_Davis
Miles_Davis_All_Stars,_Volume_2	Miles Davis All Stars, Volume 2	dbo:artist	dbr:Miles_Davis
Miles_Davis,_Volume_3	Miles Davis, Volume 3	dbo:artist	dbr:Miles_Davis
Modern_Jazz_Trumpets	Modern Jazz Trumpets	dbo:artist	dbr:Kenny_Dorham
Modern_Jazz_Trumpets	Modern Jazz Trumpets	dbo:artist	dbr:Miles_Davis
Modern_Jazz_Trumpets	Modern Jazz Trumpets	dbo:artist	dbr:Dizzy_Gillespie
Modern_Jazz_Trumpets	Modern Jazz Trumpets	dbo:artist	dbr:Fats_Navarro
Mellow_Miles	Mellow Miles	dbo:artist	dbr:Miles_Davis
Blues_in_Orbit_(Gil_Evans_album)	Blues in Orbit (Gil Evans album)	dbo:artist	dbr:Gil_Evans
Unity_(Sun_Ra_album)	Unity (Sun Ra album)	dbo:artist	dbr:Sun_Ra
Silence_(David_Murray_album)	Silence (David Murray album)	dbo:artist	dbr:David_Murray_(saxophonist)
Action_Jackson_(soundtrack)	Action Jackson (soundtrack)	dbo:artist	dbr:Vanity_(singer)
The_Private_Collection_(Charlie_Haden_album)	The Private Collection (Charlie Haden album)	dbo:artist	dbr:Charlie_Haden
Jazz_Messengers_discography	Jazz Messengers discography	dbo:artist	dbr:The_Jazz_Messengers
Intents_and_Purposes	Intents and Purposes	dbo:artist	dbr:Bill_Dixon
Envoi_(album)	Envoi (album)	dbo:artist	dbr:Bill_Dixon
Offering:_Live_at_Temple_University	Offering: Live at Temple University	dbo:artist	dbr:John_Coltrane
Bill_Laswell_discography	Bill Laswell discography	dbo:artist	dbr:Bill_Laswell
Unreleased_Tracks_from_Between_Nothingness_%26_Eternity	Unreleased Tracks from Between Nothingness & Eternity	dbo:artist	dbr:Mahavishnu_Orchestra
Katumbo_(Dance)	Katumbo (Dance)	dbo:artist	dbr:Johnny_Coles
Trilogy_(Chick_Corea_album)	Trilogy (Chick Corea album)	dbo:artist	dbr:Chick_Corea
Horace_Silver_discography	Horace Silver discography	dbo:artist	dbr:Horace_Silver
Invitation_(Jaco_Pastorius_album)	Invitation (Jaco Pastorius album)	dbo:artist	dbr:Jaco_Pastorius
First_Meeting_(Tethered_Moon_album)	First Meeting (Tethered Moon album)	dbo:artist	dbr:Gary_Peacock
First_Meeting_(Tethered_Moon_album)	First Meeting (Tethered Moon album)	dbo:artist	dbr:Masabumi_Kikuchi
Joe_Williams_Live	Joe Williams Live	dbo:artist	dbr:Joe_Williams_(jazz_singer)
The_Charlie_Parker_Story	The Charlie Parker Story	dbo:artist	dbr:Charlie_Parker
The_Most_Happy_Fella_(album)	The Most Happy Fella (album)	dbo:artist	dbr:Charlie_Rouse
The_Most_Happy_Fella_(album)	The Most Happy Fella (album)	dbo:artist	dbr:Julius_Watkins
Charlie_Parker_Memorial,_Vol._1	Charlie Parker Memorial, Vol. 1	dbo:artist	dbr:Charlie_Parker
The_Immortal_Charlie_Parker	The Immortal Charlie Parker	dbo:artist	dbr:Charlie_Parker
Charlie_Parker_Memorial,_Vol._2	Charlie Parker Memorial, Vol. 2	dbo:artist	dbr:Charlie_Parker
The_Genius_of_Charlie_Parker	The Genius of Charlie Parker	dbo:artist	dbr:Charlie_Parker
Aja_(song)	Aja (song)	dbo:artist	dbr:Steely_Dan
Travelling_(Steve_Howe_album)	Travelling (Steve Howe album)	dbo:artist	dbr:Steve_Howe_(musician)
Tenderly:_An_Informal_Session	Tenderly: An Informal Session	dbo:artist	dbr:Bill_Evans
Tenderly:_An_Informal_Session	Tenderly: An Informal Session	dbo:artist	dbr:Don_Elliott
Dedicated_to_Bill_Evans_and_Scott_LaFaro	Dedicated to Bill Evans and Scott LaFaro	dbo:artist	dbr:Larry_Coryell
Underground_Memoirs	Underground Memoirs	dbo:artist	dbr:Cedar_Walton
Manhattan_Afternoon	Manhattan Afternoon	dbo:artist	dbr:Cedar_Walton
I_Remember_You_(John_Hicks_album)	I Remember You (John Hicks album)	dbo:artist	dbr:John_Hicks_(jazz_pianist)
To_Pimp_a_Butterfly	To Pimp a Butterfly	dbo:artist	dbr:Kendrick_Lamar
Pieces_of_Eight:_Live_at_UCLA	Pieces of Eight: Live at UCLA	dbo:artist	dbr:Don_Ellis
Lover_Man_(album)	Lover Man (album)	dbo:artist	dbr:Duke_Jordan
The_Source_(Jackie_McLean_album)	The Source (Jackie McLean album)	dbo:artist	dbr:Jackie_McLean
In_the_Tradition_Volume_2	In the Tradition Volume 2	dbo:artist	dbr:Anthony_Braxton
Stable_Mable	Stable Mable	dbo:artist	dbr:Dexter_Gordon
Tete!	Tete!	dbo:artist	dbr:Tete_Montoliu
Eloquence_(Bill_Evans_album)	Eloquence (Bill Evans album)	dbo:artist	dbr:Eddie_Gómez
Eloquence_(Bill_Evans_album)	Eloquence (Bill Evans album)	dbo:artist	dbr:Bill_Evans
Something_Different_(Dexter_Gordon_album)	Something Different (Dexter Gordon album)	dbo:artist	dbr:Dexter_Gordon
19_Standards_(Quartet)_2003	19 Standards (Quartet) 2003	dbo:artist	dbr:Anthony_Braxton
20_Standards_(Quartet)_2003	20 Standards (Quartet) 2003	dbo:artist	dbr:Anthony_Braxton
Live_in_Europe_1969:_The_Bootleg_Series_Vol._2	Live in Europe 1969: The Bootleg Series Vol. 2	dbo:artist	dbr:Miles_Davis
Presenting_Red_Mitchell	Presenting Red Mitchell	dbo:artist	dbr:Red_Mitchell
The_Time_of_My_Life:_Roseanna_Vitro_Sings_the_Songs_of_Steve_Allen	The Time of My Life: Roseanna Vitro Sings the Songs of Steve Allen	dbo:artist	dbr:Roseanna_Vitro
Exploring_the_Scene!	Exploring the Scene!	dbo:artist	dbr:Barney_Kessel
Exploring_the_Scene!	Exploring the Scene!	dbo:artist	dbr:Shelly_Manne
Good_Vibes_(Johnny_Lytle_album)	Good Vibes (Johnny Lytle album)	dbo:artist	dbr:Johnny_Lytle
Double_Image_(album)	Double Image (album)	dbo:artist	dbr:George_Cables
Double_Image_(album)	Double Image (album)	dbo:artist	dbr:Frank_Morgan_(musician)
The_Green_Leaves_of_Summer_(album)	The Green Leaves of Summer (album)	dbo:artist	dbr:Hampton_Hawes
Hampton_Hawes_at_the_Piano	Hampton Hawes at the Piano	dbo:artist	dbr:Hampton_Hawes
Serious_Swingers	Serious Swingers	dbo:artist	dbr:Bud_Shank
Serious_Swingers	Serious Swingers	dbo:artist	dbr:Bill_Perkins_(saxophonist)
Pike%27s_Peak_(album)	Pike's Peak (album)	dbo:artist	dbr:Dave_Pike
High_Risk_(album)	High Risk (album)	dbo:artist	dbr:Dave_Douglas_(trumpeter)
Groovin%27_High_(Hank_Jones_album)	Groovin' High (Hank Jones album)	dbo:artist	dbr:Hank_Jones
Bluesette_(album)	Bluesette (album)	dbo:artist	dbr:Hank_Jones
Kids:_Live_at_Dizzy%27s_Club_Coca-Cola	Kids: Live at Dizzy's Club Coca-Cola	dbo:artist	dbr:Hank_Jones
Kids:_Live_at_Dizzy%27s_Club_Coca-Cola	Kids: Live at Dizzy's Club Coca-Cola	dbo:artist	dbr:Joe_Lovano
Blues_for_Sarka	Blues for Sarka	dbo:artist	dbr:New_York_Jazz_Quartet
Ready_to_Die	Ready to Die	dbo:artist	dbr:The_Notorious_B.I.G.
Amanda_(album)	Amanda (album)	dbo:artist	dbr:Randy_Brecker
Teoria_r%C3%B3wnoleg%C5%82ych_wszech%C5%9Bwiat%C3%B3w	Teoria równoległych wszechświatów	dbo:artist	dbr:Tau_(rapper)
Procession_of_the_Great_Ancestry	Procession of the Great Ancestry	dbo:artist	dbr:Wadada_Leo_Smith
Late_Night_Tales:_Nils_Frahm	Late Night Tales: Nils Frahm	dbo:artist	dbr:Nils_Frahm
